GEOID,MSA,year,num_hunits,num_hunits_owned,num_hunits_rented
3100000US10140,10140,2006,28616,18818,9798
3100000US10140,10140,2007,27388,19637,7751
3100000US10140,10140,2008,29044,18565,10479
3100000US10140,10140,2009,27759,18319,9440
310M100US10140,10140,2010,28376,19916,8460
310M100US10140,10140,2011,25619,18414,7205
310M100US10140,10140,2012,27880,19704,8176
310M200US10140,10140,2013,26815,17840,8975
310M200US10140,10140,2014,27401,17764,9637
310M200US10140,10140,2015,27430,17697,9733
310M300US10140,10140,2016,27330,19579,7751
3100000US10180,10180,2006,59850,39716,20134
3100000US10180,10180,2007,60692,40202,20490
3100000US10180,10180,2008,59960,39853,20107
3100000US10180,10180,2009,58052,37617,20435
310M100US10180,10180,2010,59857,37501,22356
310M100US10180,10180,2011,58974,39635,19339
310M100US10180,10180,2012,60066,35970,24096
310M200US10180,10180,2013,60588,39089,21499
310M200US10180,10180,2014,59932,36872,23060
310M200US10180,10180,2015,59372,36046,23326
310M300US10180,10180,2016,59263,35715,23548
3100000US10300,10300,2006,37736,29012,8724
3100000US10300,10300,2007,38000,32146,5854
3100000US10300,10300,2008,37184,29485,7699
3100000US10300,10300,2009,36835,28867,7968
310M100US10300,10300,2010,36341,29431,6910
310M100US10300,10300,2011,38055,29392,8663
310M100US10300,10300,2012,37998,28534,9464
310M200US10300,10300,2013,37270,28932,8338
310M200US10300,10300,2014,38483,28540,9943
310M200US10300,10300,2015,37016,29309,7707
310M300US10300,10300,2016,37781,29762,8019
3100000US10380,10380,2006,97900,71882,26018
3100000US10380,10380,2007,96218,73293,22925
3100000US10380,10380,2008,90763,66747,24016
3100000US10380,10380,2009,91805,68535,23270
310M100US10380,10380,2010,108256,76275,31981
310M100US10380,10380,2011,103042,70071,32971
310M100US10380,10380,2012,99474,68002,31472
310M200US10380,10380,2013,110765,73887,36878
310M200US10380,10380,2014,108557,70468,38089
310M200US10380,10380,2015,109586,72228,37358
310M300US10380,10380,2016,110316,73175,37141
3100000US10420,10420,2006,280837,196646,84191
3100000US10420,10420,2007,281669,196521,85148
3100000US10420,10420,2008,281731,193153,88578
3100000US10420,10420,2009,281769,191679,90090
310M100US10420,10420,2010,281523,194366,87157
310M100US10420,10420,2011,274696,186106,88590
310M100US10420,10420,2012,280887,188149,92738
310M200US10420,10420,2013,281324,185369,95955
310M200US10420,10420,2014,283364,186105,97259
310M200US10420,10420,2015,282456,184981,97475
310M300US10420,10420,2016,284670,186734,97936
310M100US10460,10460,2011,25312,16022,9290
310M100US10460,10460,2012,22769,14608,8161
310M200US10460,10460,2013,23176,15246,7930
310M200US10460,10460,2014,23190,14777,8413
310M200US10460,10460,2015,23919,15499,8420
310M300US10460,10460,2016,22384,15152,7232
3100000US10500,10500,2006,61158,34718,26440
3100000US10500,10500,2007,60777,34189,26588
3100000US10500,10500,2008,60893,36495,24398
3100000US10500,10500,2009,60101,36028,24073
310M100US10500,10500,2010,60263,35667,24596
310M100US10500,10500,2011,58438,32023,26415
310M100US10500,10500,2012,57699,32652,25047
310M200US10500,10500,2013,56505,30923,25582
310M200US10500,10500,2014,57795,31235,26560
310M200US10500,10500,2015,57597,31505,26092
310M300US10500,10500,2016,57228,30393,26835
3100000US10540,10540,2006,42668,28984,13684
3100000US10540,10540,2007,44444,30369,14075
3100000US10540,10540,2008,42569,27892,14677
3100000US10540,10540,2009,43953,30325,13628
310M100US10540,10540,2010,45489,30438,15051
310M100US10540,10540,2011,45399,28866,16533
310M100US10540,10540,2012,43905,29677,14228
310M200US10540,10540,2013,43911,28243,15668
310M200US10540,10540,2014,45907,30662,15245
310M200US10540,10540,2015,46315,27464,18851
310M300US10540,10540,2016,46645,30324,16321
3100000US10580,10580,2006,337905,221077,116828
3100000US10580,10580,2007,337307,225669,111638
3100000US10580,10580,2008,337729,226463,111266
3100000US10580,10580,2009,336492,224144,112348
310M100US10580,10580,2010,348634,225850,122784
310M100US10580,10580,2011,345662,228119,117543
310M100US10580,10580,2012,342705,221169,121536
310M200US10580,10580,2013,347942,225196,122746
310M200US10580,10580,2014,347291,222211,125080
310M200US10580,10580,2015,342766,218962,123804
310M300US10580,10580,2016,343069,216144,126925
3100000US10700,10700,2006,32397,24827,7570
3100000US10700,10700,2007,33737,24664,9073
3100000US10700,10700,2008,32519,23214,9305
3100000US10700,10700,2009,32651,23278,9373
310M100US10700,10700,2010,35024,24796,10228
310M100US10700,10700,2011,33750,25136,8614
310M100US10700,10700,2012,33802,24341,9461
310M200US10700,10700,2013,33738,24523,9215
310M200US10700,10700,2014,34872,23474,11398
310M200US10700,10700,2015,33972,24887,9085
310M300US10700,10700,2016,34726,23374,11352
3100000US10740,10740,2006,318482,218800,99682
3100000US10740,10740,2007,322464,220936,101528
3100000US10740,10740,2008,331371,224622,106749
3100000US10740,10740,2009,334647,224529,110118
310M100US10740,10740,2010,344800,230349,114451
310M100US10740,10740,2011,345157,229639,115518
310M100US10740,10740,2012,344869,230429,114440
310M200US10740,10740,2013,336614,221382,115232
310M200US10740,10740,2014,342552,224591,117961
310M200US10740,10740,2015,342590,227921,114669
310M300US10740,10740,2016,343912,234348,109564
3100000US10780,10780,2006,55546,37650,17896
3100000US10780,10780,2007,58013,39028,18985
3100000US10780,10780,2008,55444,38624,16820
3100000US10780,10780,2009,56272,38486,17786
310M100US10780,10780,2010,54774,36786,17988
310M100US10780,10780,2011,51981,35452,16529
310M100US10780,10780,2012,57277,38008,19269
310M200US10780,10780,2013,55320,36165,19155
310M200US10780,10780,2014,53802,34153,19649
310M200US10780,10780,2015,54406,31228,23178
310M300US10780,10780,2016,55246,33568,21678
3100000US10880,10880,2006,41642,35295,6347
3100000US10880,10880,2007,41008,33935,7073
3100000US10880,10880,2008,41648,33921,7727
3100000US10880,10880,2009,41660,34378,7282
310M100US10880,10880,2010,41724,34248,7476
310M100US10880,10880,2011,40921,33727,7194
310M100US10880,10880,2012,42930,34073,8857
3100000US10900,10900,2006,305792,224503,81289
3100000US10900,10900,2007,308726,223014,85712
3100000US10900,10900,2008,311209,229340,81869
3100000US10900,10900,2009,306116,222240,83876
310M100US10900,10900,2010,311470,223955,87515
310M100US10900,10900,2011,312237,223811,88426
310M100US10900,10900,2012,314173,218965,95208
310M200US10900,10900,2013,313226,217571,95655
310M200US10900,10900,2014,315376,220337,95039
310M200US10900,10900,2015,314985,217420,97565
310M300US10900,10900,2016,317457,216007,101450
3100000US11020,11020,2006,50528,37443,13085
3100000US11020,11020,2007,51231,36501,14730
3100000US11020,11020,2008,50854,36557,14297
3100000US11020,11020,2009,53155,38844,14311
310M100US11020,11020,2010,52111,37314,14797
310M100US11020,11020,2011,50849,37869,12980
310M100US11020,11020,2012,50098,35283,14815
310M200US11020,11020,2013,51284,36692,14592
310M200US11020,11020,2014,49678,35525,14153
310M200US11020,11020,2015,52830,37290,15540
310M300US11020,11020,2016,51154,35090,16064
3100000US11100,11100,2006,87290,56566,30724
3100000US11100,11100,2007,86729,55544,31185
3100000US11100,11100,2008,88099,57098,31001
3100000US11100,11100,2009,88271,56811,31460
310M100US11100,11100,2010,94287,60160,34127
310M100US11100,11100,2011,94589,61745,32844
310M100US11100,11100,2012,94559,60288,34271
310M200US11100,11100,2013,96382,61708,34674
310M200US11100,11100,2014,95667,61473,34194
310M200US11100,11100,2015,95626,60980,34646
310M300US11100,11100,2016,95619,60329,35290
3100000US11180,11180,2006,31909,18144,13765
3100000US11180,11180,2007,32272,18021,14251
3100000US11180,11180,2008,32769,18131,14638
3100000US11180,11180,2009,32434,18537,13897
310M100US11180,11180,2010,35851,18667,17184
310M100US11180,11180,2011,34794,19154,15640
310M100US11180,11180,2012,35541,19882,15659
310M200US11180,11180,2013,36340,18737,17603
310M200US11180,11180,2014,35880,18595,17285
310M200US11180,11180,2015,37264,19868,17396
310M300US11180,11180,2016,37350,19327,18023
3100000US11260,11260,2006,123892,79742,44150
3100000US11260,11260,2007,125039,80156,44883
3100000US11260,11260,2008,126126,83386,42740
3100000US11260,11260,2009,126818,83060,43758
310M100US11260,11260,2010,135320,88256,47064
310M100US11260,11260,2011,139979,88296,51683
310M100US11260,11260,2012,137052,87094,49958
310M200US11260,11260,2013,133717,84337,49380
310M200US11260,11260,2014,135449,84469,50980
310M200US11260,11260,2015,135601,87689,47912
310M300US11260,11260,2016,135554,87412,48142
3100000US11300,11300,2006,51975,37692,14283
3100000US11300,11300,2007,51598,37599,13999
3100000US11300,11300,2008,51759,39836,11923
3100000US11300,11300,2009,51043,37640,13403
310M100US11300,11300,2010,50641,35707,14934
310M100US11300,11300,2011,49713,35043,14670
310M100US11300,11300,2012,49124,34108,15016
3100000US11340,11340,2006,69306,51333,17973
3100000US11340,11340,2007,70116,52622,17494
3100000US11340,11340,2008,71728,54922,16806
3100000US11340,11340,2009,73101,52637,20464
310M100US11340,11340,2010,73794,53622,20172
310M100US11340,11340,2011,72551,51886,20665
310M100US11340,11340,2012,72363,53669,18694
3100000US11460,11460,2006,134052,84028,50024
3100000US11460,11460,2007,133075,87094,45981
3100000US11460,11460,2008,134797,84266,50531
3100000US11460,11460,2009,134142,82749,51393
310M100US11460,11460,2010,132028,82391,49637
310M100US11460,11460,2011,134459,80577,53882
310M100US11460,11460,2012,137565,80672,56893
310M200US11460,11460,2013,137728,81821,55907
310M200US11460,11460,2014,137240,82580,54660
310M200US11460,11460,2015,138099,81042,57057
310M300US11460,11460,2016,140079,82939,57140
3100000US11500,11500,2006,46503,33457,13046
3100000US11500,11500,2007,46785,33088,13697
3100000US11500,11500,2008,46640,34892,11748
3100000US11500,11500,2009,46535,32906,13629
310M100US11500,11500,2010,45862,30941,14921
310M100US11500,11500,2011,44722,30699,14023
310M100US11500,11500,2012,45986,31455,14531
310M200US11500,11500,2013,43851,29414,14437
310M200US11500,11500,2014,46087,31712,14375
310M200US11500,11500,2015,44323,30753,13570
310M300US11500,11500,2016,43972,29321,14651
3100000US11540,11540,2006,85708,62992,22716
3100000US11540,11540,2007,85026,62813,22213
3100000US11540,11540,2008,86567,65124,21443
3100000US11540,11540,2009,86531,65136,21395
310M100US11540,11540,2010,88085,66654,21431
310M100US11540,11540,2011,86914,64412,22502
310M100US11540,11540,2012,87010,64590,22420
310M200US11540,11540,2013,89376,64891,24485
310M200US11540,11540,2014,90046,63962,26084
310M200US11540,11540,2015,90489,66679,23810
310M300US11540,11540,2016,92593,67679,24914
310M200US11640,11640,2013,68222,45499,22723
310M200US11640,11640,2014,64990,44240,20750
310M200US11640,11640,2015,66729,45759,20970
310M300US11640,11640,2016,66520,47512,19008
3100000US11700,11700,2006,166210,117975,48235
3100000US11700,11700,2007,172124,123457,48667
3100000US11700,11700,2008,176138,122858,53280
3100000US11700,11700,2009,172316,123612,48704
310M100US11700,11700,2010,181239,126621,54618
310M100US11700,11700,2011,180249,120258,59991
310M100US11700,11700,2012,178131,122667,55464
310M200US11700,11700,2013,182426,122104,60322
310M200US11700,11700,2014,182129,122265,59864
310M200US11700,11700,2015,184983,123167,61816
310M300US11700,11700,2016,186656,127543,59113
3100000US11780,11780,2006,39758,27605,12153
3100000US11780,11780,2007,38022,27517,10505
3100000US11780,11780,2008,38189,27019,11170
3100000US11780,11780,2009,37998,27381,10617
310M100US11780,11780,2010,38078,27623,10455
310M100US11780,11780,2011,39383,28049,11334
310M100US11780,11780,2012,39008,27949,11059
310M200US11780,11780,2013,39393,29005,10388
310M200US11780,11780,2014,38891,27085,11806
310M200US11780,11780,2015,37333,25704,11629
310M300US11780,11780,2016,38728,27825,10903
310M200US11900,11900,2015,22757,12782,9975
310M300US11900,11900,2016,21732,12917,8815
3100000US11980,11980,2006,29399,22361,7038
3100000US11980,11980,2007,29708,23966,5742
3100000US11980,11980,2008,30860,23533,7327
3100000US11980,11980,2009,30963,23589,7374
310M100US11980,11980,2010,29810,22753,7057
310M100US11980,11980,2011,29567,22069,7498
310M100US11980,11980,2012,29273,21224,8049
310M200US11980,11980,2013,28070,20211,7859
310M200US11980,11980,2014,30422,23119,7303
310M200US11980,11980,2015,29103,21088,8015
310M300US11980,11980,2016,30403,22982,7421
3100000US12020,12020,2006,69430,39520,29910
3100000US12020,12020,2007,69940,41803,28137
3100000US12020,12020,2008,66851,39541,27310
3100000US12020,12020,2009,64907,38578,26329
310M100US12020,12020,2010,64210,37959,26251
310M100US12020,12020,2011,66123,37421,28702
310M100US12020,12020,2012,67610,37944,29666
310M200US12020,12020,2013,71847,37014,34833
310M200US12020,12020,2014,71814,36924,34890
310M200US12020,12020,2015,76704,41003,35701
310M300US12020,12020,2016,78195,39773,38422
3100000US12060,12060,2006,1826990,1261351,565639
3100000US12060,12060,2007,1867083,1298668,568415
3100000US12060,12060,2008,1891993,1298850,593143
3100000US12060,12060,2009,1885202,1291011,594191
310M100US12060,12060,2010,1879479,1249819,629660
310M100US12060,12060,2011,1896087,1219873,676214
310M100US12060,12060,2012,1923727,1227569,696158
310M200US12060,12060,2013,1954348,1237449,716899
310M200US12060,12060,2014,1981447,1236658,744789
310M200US12060,12060,2015,2028705,1248726,779979
310M300US12060,12060,2016,2062798,1264846,797952
3100000US12100,12100,2006,103504,70698,32806
3100000US12100,12100,2007,103197,72038,31159
3100000US12100,12100,2008,101076,73110,27966
3100000US12100,12100,2009,101681,71846,29835
310M100US12100,12100,2010,100096,73515,26581
310M100US12100,12100,2011,99762,66755,33007
310M100US12100,12100,2012,100065,64897,35168
310M200US12100,12100,2013,101721,67645,34076
310M200US12100,12100,2014,101937,67981,33956
310M200US12100,12100,2015,101813,69152,32661
310M300US12100,12100,2016,96777,65459,31318
3100000US12180,12180,2006,31818,23012,8806
3100000US12180,12180,2007,31468,22950,8518
3100000US12180,12180,2008,31088,22011,9077
3100000US12180,12180,2009,32470,22879,9591
310M100US12180,12180,2010,30975,22879,8096
310M100US12180,12180,2011,31533,22547,8986
310M100US12180,12180,2012,30354,21703,8651
310M200US12180,12180,2013,30784,22224,8560
310M200US12180,12180,2014,31290,21833,9457
310M200US12180,12180,2015,31368,22034,9334
310M300US12180,12180,2016,30966,21833,9133
3100000US12220,12220,2006,52223,33816,18407
3100000US12220,12220,2007,55735,33557,22178
3100000US12220,12220,2008,55986,36800,19186
3100000US12220,12220,2009,56150,34307,21843
310M100US12220,12220,2010,55073,35050,20023
310M100US12220,12220,2011,56274,34167,22107
310M100US12220,12220,2012,55520,34532,20988
310M200US12220,12220,2013,56840,32878,23962
310M200US12220,12220,2014,57880,33558,24322
310M200US12220,12220,2015,58191,33789,24402
310M300US12220,12220,2016,59354,34720,24634
3100000US12260,12260,2006,196092,137539,58553
3100000US12260,12260,2007,200132,138672,61460
3100000US12260,12260,2008,197783,138731,59052
3100000US12260,12260,2009,201260,136200,65060
310M100US12260,12260,2010,206641,139695,66946
310M100US12260,12260,2011,207222,138991,68231
310M100US12260,12260,2012,204147,135425,68722
310M200US12260,12260,2013,204221,136979,67242
310M200US12260,12260,2014,208479,138872,69607
310M200US12260,12260,2015,210854,140520,70334
310M300US12260,12260,2016,219167,144131,75036
3100000US12300,12300,2006,51207,36414,14793
3100000US12300,12300,2007,50450,37072,13378
3100000US12300,12300,2008,48859,35928,12931
3100000US12300,12300,2009,52054,37365,14689
310M100US12300,12300,2010,51225,36515,14710
310M100US12300,12300,2011,51808,36556,15252
310M100US12300,12300,2012,51547,36092,15455
310M200US12300,12300,2013,50670,35354,15316
310M200US12300,12300,2014,50219,35852,14367
310M200US12300,12300,2015,51121,35826,15295
310M300US12300,12300,2016,47791,33690,14101
3100000US12420,12420,2006,560280,337496,222784
3100000US12420,12420,2007,583598,349024,234574
3100000US12420,12420,2008,603680,365596,238084
3100000US12420,12420,2009,614047,360198,253849
310M100US12420,12420,2010,647500,371932,275568
310M100US12420,12420,2011,663866,376355,287511
310M100US12420,12420,2012,665027,383417,281610
310M200US12420,12420,2013,688938,400914,288024
310M200US12420,12420,2014,703976,401992,301984
310M200US12420,12420,2015,723914,416469,307445
310M300US12420,12420,2016,741176,427223,313953
3100000US12540,12540,2006,238229,147483,90746
3100000US12540,12540,2007,239662,147822,91840
3100000US12540,12540,2008,244186,145468,98718
3100000US12540,12540,2009,241764,145330,96434
310M100US12540,12540,2010,252284,148939,103345
310M100US12540,12540,2011,254761,144094,110667
310M100US12540,12540,2012,255967,147900,108067
310M200US12540,12540,2013,257183,137511,119672
310M200US12540,12540,2014,261135,147728,113407
310M200US12540,12540,2015,263273,148991,114282
310M300US12540,12540,2016,270359,154029,116330
3100000US12580,12580,2006,1003904,689791,314113
3100000US12580,12580,2007,995655,688118,307537
3100000US12580,12580,2008,1005383,682184,323199
3100000US12580,12580,2009,1005051,683583,321468
310M100US12580,12580,2010,1022553,674751,347802
310M100US12580,12580,2011,1022508,682843,339665
310M100US12580,12580,2012,1034914,681857,353057
310M200US12580,12580,2013,1037921,684387,353534
310M200US12580,12580,2014,1032604,676381,356223
310M200US12580,12580,2015,1037443,680671,356772
310M300US12580,12580,2016,1045165,682832,362333
3100000US12620,12620,2006,60132,43291,16841
3100000US12620,12620,2007,61434,45007,16427
3100000US12620,12620,2008,61463,41570,19893
3100000US12620,12620,2009,61911,42656,19255
310M100US12620,12620,2010,60428,41858,18570
310M100US12620,12620,2011,62303,41084,21219
310M100US12620,12620,2012,63171,41133,22038
310M200US12620,12620,2013,62039,40592,21447
310M200US12620,12620,2014,61218,41939,19279
310M200US12620,12620,2015,59099,40544,18555
310M300US12620,12620,2016,60195,42995,17200
3100000US12700,12700,2006,98466,77889,20577
3100000US12700,12700,2007,97560,78531,19029
3100000US12700,12700,2008,93027,75556,17471
3100000US12700,12700,2009,99904,80680,19224
310M100US12700,12700,2010,93576,72481,21095
310M100US12700,12700,2011,94569,72494,22075
310M100US12700,12700,2012,89766,73236,16530
310M200US12700,12700,2013,94479,73293,21186
310M200US12700,12700,2014,95697,75965,19732
310M200US12700,12700,2015,97451,75441,22010
310M300US12700,12700,2016,92582,72842,19740
3100000US12940,12940,2006,279234,189507,89727
3100000US12940,12940,2007,287639,198398,89241
3100000US12940,12940,2008,293615,200617,92998
3100000US12940,12940,2009,294764,199744,95020
310M100US12940,12940,2010,291692,201706,89986
310M100US12940,12940,2011,294852,204753,90099
310M100US12940,12940,2012,298690,201773,96917
310M200US12940,12940,2013,301385,204773,96612
310M200US12940,12940,2014,305096,200073,105023
310M200US12940,12940,2015,300535,208849,91686
310M300US12940,12940,2016,296740,197479,99261
3100000US12980,12980,2006,53762,40645,13117
3100000US12980,12980,2007,54146,38964,15182
3100000US12980,12980,2008,52624,36659,15965
3100000US12980,12980,2009,54528,38489,16039
310M100US12980,12980,2010,52600,37953,14647
310M100US12980,12980,2011,51814,35513,16301
310M100US12980,12980,2012,53182,35926,17256
310M200US12980,12980,2013,52980,36561,16419
310M200US12980,12980,2014,52385,37308,15077
310M200US12980,12980,2015,53076,36763,16313
310M300US12980,12980,2016,52888,36599,16289
3100000US13020,13020,2006,44961,36153,8808
3100000US13020,13020,2007,43987,35079,8908
3100000US13020,13020,2008,43344,33464,9880
3100000US13020,13020,2009,44589,35514,9075
310M100US13020,13020,2010,44064,34330,9734
310M100US13020,13020,2011,43084,34223,8861
310M100US13020,13020,2012,43967,34067,9900
310M200US13020,13020,2013,44918,34344,10574
310M200US13020,13020,2014,42706,33533,9173
310M200US13020,13020,2015,42799,32907,9892
310M300US13020,13020,2016,43876,35677,8199
3100000US13140,13140,2006,142716,99353,43363
3100000US13140,13140,2007,141857,99151,42706
3100000US13140,13140,2008,146699,102253,44446
3100000US13140,13140,2009,150564,100046,50518
310M100US13140,13140,2010,140356,94933,45423
310M100US13140,13140,2011,144011,99119,44892
310M100US13140,13140,2012,143663,100048,43615
310M200US13140,13140,2013,150700,102716,47984
310M200US13140,13140,2014,152806,101996,50810
310M200US13140,13140,2015,153283,103305,49978
310M300US13140,13140,2016,152244,99938,52306
3100000US13180,13180,2006,32917,24257,8660
3100000US13180,13180,2007,34235,24962,9273
3100000US13180,13180,2008,34561,25000,9561
3100000US13180,13180,2009,34087,25250,8837
310M100US13180,13180,2010,33256,24107,9149
310M100US13180,13180,2011,32762,24033,8729
310M100US13180,13180,2012,33183,25382,7801
310M200US13180,13180,2013,31784,22718,9066
310M200US13180,13180,2014,33273,23888,9385
310M200US13180,13180,2015,34805,23837,10968
310M300US13180,13180,2016,34648,23914,10734
3100000US13220,13220,2006,32302,24102,8200
3100000US13220,13220,2007,30515,23786,6729
3100000US13220,13220,2008,32394,25049,7345
3100000US13220,13220,2009,32614,23980,8634
310M100US13220,13220,2010,31514,24087,7427
310M100US13220,13220,2011,32121,23089,9032
310M100US13220,13220,2012,30834,22714,8120
310M200US13220,13220,2013,47633,35482,12151
310M200US13220,13220,2014,49335,37782,11553
310M200US13220,13220,2015,49070,35796,13274
310M300US13220,13220,2016,47940,35492,12448
3100000US13380,13380,2006,74795,46545,28250
3100000US13380,13380,2007,75759,46474,29285
3100000US13380,13380,2008,76031,46716,29315
3100000US13380,13380,2009,77437,48376,29061
310M100US13380,13380,2010,80288,49116,31172
310M100US13380,13380,2011,79958,51859,28099
310M100US13380,13380,2012,79029,49232,29797
310M200US13380,13380,2013,78330,48982,29348
310M200US13380,13380,2014,81973,51213,30760
310M200US13380,13380,2015,80023,50981,29042
310M300US13380,13380,2016,84011,49830,34181
3100000US13460,13460,2006,59676,41573,18103
3100000US13460,13460,2007,62622,42845,19777
3100000US13460,13460,2008,63383,42755,20628
3100000US13460,13460,2009,63885,43972,19913
310M100US13460,13460,2010,64120,41634,22486
310M100US13460,13460,2011,64678,40880,23798
310M100US13460,13460,2012,66086,42364,23722
310M200US13460,13460,2013,65065,41646,23419
310M200US13460,13460,2014,66218,43461,22757
310M200US13460,13460,2015,69424,44564,24860
310M300US13460,13460,2016,71262,47855,23407
3100000US13740,13740,2006,58418,42398,16020
3100000US13740,13740,2007,59079,42820,16259
3100000US13740,13740,2008,60295,41271,19024
3100000US13740,13740,2009,61426,43228,18198
310M100US13740,13740,2010,65861,45947,19914
310M100US13740,13740,2011,63921,45253,18668
310M100US13740,13740,2012,65215,44965,20250
310M200US13740,13740,2013,66597,43923,22674
310M200US13740,13740,2014,66824,45475,21349
310M200US13740,13740,2015,68021,45911,22110
310M300US13740,13740,2016,69484,48685,20799
3100000US13780,13780,2006,101502,70761,30741
3100000US13780,13780,2007,99267,68528,30739
3100000US13780,13780,2008,98248,67763,30485
3100000US13780,13780,2009,99339,67821,31518
310M100US13780,13780,2010,100830,70807,30023
310M100US13780,13780,2011,100142,68536,31606
310M100US13780,13780,2012,101258,69879,31379
310M200US13780,13780,2013,96729,67539,29190
310M200US13780,13780,2014,99298,66277,33021
310M200US13780,13780,2015,97883,65968,31915
310M300US13780,13780,2016,96261,63945,32316
3100000US13820,13820,2006,426691,313029,113662
3100000US13820,13820,2007,431741,311647,120094
3100000US13820,13820,2008,432089,310765,121324
3100000US13820,13820,2009,445499,313964,131535
310M100US13820,13820,2010,430441,304304,126137
310M100US13820,13820,2011,433066,303215,129851
310M100US13820,13820,2012,437667,303883,133784
310M200US13820,13820,2013,431462,297170,134292
310M200US13820,13820,2014,439531,296688,142843
310M200US13820,13820,2015,441762,304498,137264
310M300US13820,13820,2016,438479,304437,134042
3100000US13900,13900,2006,42282,29860,12422
3100000US13900,13900,2007,42170,28882,13288
3100000US13900,13900,2008,42273,30891,11382
3100000US13900,13900,2009,43837,32261,11576
310M100US13900,13900,2010,44857,33951,10906
310M100US13900,13900,2011,45689,33119,12570
310M100US13900,13900,2012,46991,34096,12895
310M200US13900,13900,2013,50980,37135,13845
310M200US13900,13900,2014,53813,37242,16571
310M200US13900,13900,2015,55092,37334,17758
310M300US13900,13900,2016,54085,37547,16538
3100000US13980,13980,2006,58647,36242,22405
3100000US13980,13980,2007,62089,38362,23727
3100000US13980,13980,2008,62291,38873,23418
3100000US13980,13980,2009,60904,35808,25096
310M100US13980,13980,2010,62446,40167,22279
310M100US13980,13980,2011,61522,36250,25272
310M100US13980,13980,2012,63346,36897,26449
310M200US13980,13980,2013,69246,42236,27010
310M200US13980,13980,2014,67185,41064,26121
310M200US13980,13980,2015,69396,42867,26529
310M300US13980,13980,2016,70441,42619,27822
310M200US14010,14010,2013,72165,49365,22800
310M200US14010,14010,2014,72551,46970,25581
310M200US14010,14010,2015,72767,47847,24920
310M300US14010,14010,2016,71716,47444,24272
3100000US14020,14020,2006,66384,43564,22820
3100000US14020,14020,2007,70431,44459,25972
3100000US14020,14020,2008,74805,46417,28388
3100000US14020,14020,2009,75989,45896,30093
310M100US14020,14020,2010,74442,46088,28354
310M100US14020,14020,2011,75591,46272,29319
310M100US14020,14020,2012,76163,46111,30052
310M200US14020,14020,2013,61647,34128,27519
310M200US14020,14020,2014,61929,35715,26214
310M200US14020,14020,2015,62702,35698,27004
310M300US14020,14020,2016,64040,37458,26582
3100000US14060,14060,2006,61700,41428,20272
3100000US14060,14060,2007,62671,42651,20020
3100000US14060,14060,2008,62806,42756,20050
3100000US14060,14060,2009,63982,42396,21586
310M100US14060,14060,2010,61576,42229,19347
310M100US14060,14060,2011,63240,41959,21281
310M100US14060,14060,2012,65744,43312,22432
3100000US14100,14100,2006,32870,25142,7728
3100000US14100,14100,2007,32603,24008,8595
3100000US14100,14100,2008,32540,23685,8855
3100000US14100,14100,2009,33584,23635,9949
310M100US14100,14100,2010,33929,23927,10002
310M100US14100,14100,2011,32928,23613,9315
310M100US14100,14100,2012,33705,24501,9204
310M200US14100,14100,2013,33976,23896,10080
310M200US14100,14100,2014,33873,24338,9535
310M200US14100,14100,2015,33140,23624,9516
310M300US14100,14100,2016,33824,23176,10648
3100000US14140,14140,2006,42978,32169,10809
3100000US14140,14140,2007,42417,31390,11027
3100000US14140,14140,2008,43033,30488,12545
3100000US14140,14140,2009,43779,31913,11866
310M100US14140,14140,2010,44395,32371,12024
310M100US14140,14140,2011,44410,31391,13019
310M100US14140,14140,2012,43794,30910,12884
310M200US14140,14140,2013,43087,31881,11206
310M200US14140,14140,2014,42039,31614,10425
310M200US14140,14140,2015,41838,30472,11366
310M300US14140,14140,2016,40816,29070,11746
3100000US14260,14260,2006,213517,153753,59764
3100000US14260,14260,2007,219026,156285,62741
3100000US14260,14260,2008,220397,155546,64851
3100000US14260,14260,2009,218186,153774,64412
310M100US14260,14260,2010,225007,153423,71584
310M100US14260,14260,2011,227276,154917,72359
310M100US14260,14260,2012,231388,153057,78331
310M200US14260,14260,2013,233789,159103,74686
310M200US14260,14260,2014,240402,161692,78710
310M200US14260,14260,2015,245109,167604,77505
310M300US14260,14260,2016,251142,170925,80217
3100000US14460,14460,2006,1684493,1082956,601537
3100000US14460,14460,2007,1684749,1091078,593671
3100000US14460,14460,2008,1707169,1087679,619490
3100000US14460,14460,2009,1705413,1081916,623497
310M100US14460,14460,2010,1745690,1076626,669064
310M100US14460,14460,2011,1761868,1080710,681158
310M100US14460,14460,2012,1757711,1077125,680586
310M200US14460,14460,2013,1763437,1070637,692800
310M200US14460,14460,2014,1777817,1087964,689853
310M200US14460,14460,2015,1782655,1090903,691752
310M300US14460,14460,2016,1803269,1106093,697176
3100000US14500,14500,2006,112947,74561,38386
3100000US14500,14500,2007,114056,75173,38883
3100000US14500,14500,2008,118434,77053,41381
3100000US14500,14500,2009,117222,75110,42112
310M100US14500,14500,2010,119774,74564,45210
310M100US14500,14500,2011,118559,77825,40734
310M100US14500,14500,2012,121743,74639,47104
310M200US14500,14500,2013,123498,78168,45330
310M200US14500,14500,2014,123690,75661,48029
310M200US14500,14500,2015,124615,74800,49815
310M300US14500,14500,2016,123820,80109,43711
3100000US14540,14540,2006,43733,28811,14922
3100000US14540,14540,2007,45776,30415,15361
3100000US14540,14540,2008,47135,29009,18126
3100000US14540,14540,2009,47479,30343,17136
310M100US14540,14540,2010,47972,28525,19447
310M100US14540,14540,2011,48500,30551,17949
310M100US14540,14540,2012,50137,28588,21549
310M200US14540,14540,2013,62741,41085,21656
310M200US14540,14540,2014,61834,38263,23571
310M200US14540,14540,2015,62500,38417,24083
310M300US14540,14540,2016,65832,40989,24843
3100000US14580,14580,2006,32040,21221,10819
3100000US14580,14580,2007,33625,21643,11982
3100000US14580,14580,2008,34221,21190,13031
3100000US14580,14580,2009,33860,21047,12813
310M100US14580,14580,2010,35344,22148,13196
310M100US14580,14580,2011,37196,23129,14067
310M100US14580,14580,2012,36191,21156,15035
310M200US14580,14580,2013,37767,23549,14218
310M200US14580,14580,2014,39067,23127,15940
310M200US14580,14580,2015,40692,25529,15163
310M300US14580,14580,2016,39644,23877,15767
3100000US14600,14600,2008,293837,217993,75844
3100000US14600,14600,2009,291872,217070,74802
3100000US14660,14660,2006,39144,32140,7004
3100000US14660,14660,2007,40001,32031,7970
3100000US14660,14660,2008,40195,30729,9466
3100000US14660,14660,2009,41899,31899,10000
310M100US14660,14660,2010,40153,30534,9619
310M100US14660,14660,2011,37968,30320,7648
310M100US14660,14660,2012,39850,30261,9589
310M200US14660,14660,2013,39510,29876,9634
310M200US14660,14660,2014,39920,30107,9813
310M200US14660,14660,2015,39747,30631,9116
310M300US14660,14660,2016,37034,29270,7764
3100000US14700,14700,2006,33184,22024,11160
3100000US14700,14700,2007,31528,22391,9137
3100000US14700,14700,2008,30187,22329,7858
3100000US14700,14700,2009,32601,22480,10121
310M100US14700,14700,2010,30461,22195,8266
310M100US14700,14700,2011,34352,23696,10656
310M100US14700,14700,2012,32180,21467,10713
310M200US14700,14700,2013,34561,23736,10825
310M200US14700,14700,2014,35340,24641,10699
310M200US14700,14700,2015,34749,21785,12964
310M300US14700,14700,2016,34723,21873,12850
3100000US14740,14740,2006,92239,62276,29963
3100000US14740,14740,2007,90010,62801,27209
3100000US14740,14740,2008,93399,64602,28797
3100000US14740,14740,2009,90756,64869,25887
310M100US14740,14740,2010,99150,64764,34386
310M100US14740,14740,2011,100688,65478,35210
310M100US14740,14740,2012,97027,66361,30666
310M200US14740,14740,2013,97854,67239,30615
310M200US14740,14740,2014,95249,62211,33038
310M200US14740,14740,2015,98490,67145,31345
310M300US14740,14740,2016,101995,66771,35224
3100000US14860,14860,2006,325913,232042,93871
3100000US14860,14860,2007,323848,232383,91465
3100000US14860,14860,2008,323987,233244,90743
3100000US14860,14860,2009,329241,230979,98262
310M100US14860,14860,2010,329091,227019,102072
310M100US14860,14860,2011,331530,224687,106843
310M100US14860,14860,2012,334255,228219,106036
310M200US14860,14860,2013,328062,222530,105532
310M200US14860,14860,2014,338421,227523,110898
310M200US14860,14860,2015,333528,224924,108604
310M300US14860,14860,2016,335318,218849,116469
3100000US15180,15180,2006,116070,80495,35575
3100000US15180,15180,2007,117508,79785,37723
3100000US15180,15180,2008,117559,79220,38339
3100000US15180,15180,2009,117030,77576,39454
310M100US15180,15180,2010,115579,78084,37495
310M100US15180,15180,2011,118782,80592,38190
310M100US15180,15180,2012,121179,77925,43254
310M200US15180,15180,2013,118546,81426,37120
310M200US15180,15180,2014,121009,81004,40005
310M200US15180,15180,2015,122468,80821,41647
310M300US15180,15180,2016,120499,80089,40410
3100000US15260,15260,2006,38090,26411,11679
3100000US15260,15260,2007,40708,26295,14413
3100000US15260,15260,2008,37986,26402,11584
3100000US15260,15260,2009,40748,27355,13393
310M100US15260,15260,2010,43625,28788,14837
310M100US15260,15260,2011,42363,29250,13113
310M100US15260,15260,2012,41858,28094,13764
310M200US15260,15260,2013,42749,27407,15342
310M200US15260,15260,2014,43618,28454,15164
310M200US15260,15260,2015,46647,29320,17327
310M300US15260,15260,2016,42849,28105,14744
3100000US15380,15380,2006,459740,307035,152705
3100000US15380,15380,2007,467174,314396,152778
3100000US15380,15380,2008,471545,314288,157257
3100000US15380,15380,2009,465277,309777,155500
310M100US15380,15380,2010,464581,304382,160199
310M100US15380,15380,2011,467535,307685,159850
310M100US15380,15380,2012,468089,308473,159616
310M200US15380,15380,2013,469897,309935,159962
310M200US15380,15380,2014,470564,312613,157951
310M200US15380,15380,2015,467992,305207,162785
310M300US15380,15380,2016,467259,308105,159154
3100000US15500,15500,2006,56380,36525,19855
3100000US15500,15500,2007,58225,39902,18323
3100000US15500,15500,2008,59882,39533,20349
3100000US15500,15500,2009,58084,40259,17825
310M100US15500,15500,2010,59811,39077,20734
310M100US15500,15500,2011,60824,41491,19333
310M100US15500,15500,2012,59520,38016,21504
310M200US15500,15500,2013,59200,38808,20392
310M200US15500,15500,2014,62799,41058,21741
310M200US15500,15500,2015,63093,39515,23578
310M300US15500,15500,2016,64369,41019,23350
3100000US15540,15540,2006,80544,56897,23647
3100000US15540,15540,2007,81096,57524,23572
3100000US15540,15540,2008,81777,57629,24148
3100000US15540,15540,2009,80943,55910,25033
310M100US15540,15540,2010,84093,55796,28297
310M100US15540,15540,2011,84487,57741,26746
310M100US15540,15540,2012,84977,57466,27511
310M200US15540,15540,2013,84400,56719,27681
310M200US15540,15540,2014,85222,57176,28046
310M200US15540,15540,2015,85553,56210,29343
310M300US15540,15540,2016,85740,56008,29732
310M200US15680,15680,2013,36083,26887,9196
310M200US15680,15680,2014,39179,27130,12049
310M200US15680,15680,2015,39029,27636,11393
310M300US15680,15680,2016,41368,28023,13345
3100000US15940,15940,2006,162628,116789,45839
3100000US15940,15940,2007,162009,118326,43683
3100000US15940,15940,2008,161966,112984,48982
3100000US15940,15940,2009,161609,113291,48318
310M100US15940,15940,2010,159421,115513,43908
310M100US15940,15940,2011,159981,112276,47705
310M100US15940,15940,2012,161763,112001,49762
310M200US15940,15940,2013,160166,111572,48594
310M200US15940,15940,2014,159604,108896,50708
310M200US15940,15940,2015,162868,112419,50449
310M300US15940,15940,2016,163203,113666,49537
3100000US15980,15980,2006,248128,186108,62020
3100000US15980,15980,2007,247392,183501,63891
3100000US15980,15980,2008,243923,183056,60867
3100000US15980,15980,2009,238137,174228,63909
310M100US15980,15980,2010,233693,165885,67808
310M100US15980,15980,2011,238389,169394,68995
310M100US15980,15980,2012,245100,166960,78140
310M200US15980,15980,2013,241238,167114,74124
310M200US15980,15980,2014,263295,176471,86824
310M200US15980,15980,2015,263694,182806,80888
310M300US15980,15980,2016,261735,183684,78051
3100000US16020,16020,2006,37599,26488,11111
3100000US16020,16020,2007,37374,25504,11870
3100000US16020,16020,2008,37046,25479,11567
3100000US16020,16020,2009,35413,25547,9866
310M100US16020,16020,2010,36922,24574,12348
310M100US16020,16020,2011,36332,23975,12357
310M100US16020,16020,2012,37612,25888,11724
310M200US16020,16020,2013,36158,23505,12653
310M200US16020,16020,2014,37842,25979,11863
310M200US16020,16020,2015,35273,23324,11949
310M300US16020,16020,2016,36202,24716,11486
310M200US16060,16060,2013,50870,32486,18384
310M200US16060,16060,2014,50423,30986,19437
310M200US16060,16060,2015,48012,31127,16885
310M300US16060,16060,2016,51761,31266,20495
3100000US16180,16180,2009,20464,13207,7257
310M100US16180,16180,2010,20564,12089,8475
310M100US16180,16180,2011,21129,12364,8765
310M100US16180,16180,2012,21494,11452,10042
310M200US16180,16180,2013,21076,11529,9547
310M200US16180,16180,2014,21228,12283,8945
310M200US16180,16180,2015,22687,12321,10366
310M300US16180,16180,2016,21704,11868,9836
3100000US16220,16220,2006,27719,20028,7691
3100000US16220,16220,2007,27230,18146,9084
3100000US16220,16220,2008,28180,19776,8404
3100000US16220,16220,2009,28776,20552,8224
310M100US16220,16220,2010,30763,22023,8740
310M100US16220,16220,2011,30158,20713,9445
310M100US16220,16220,2012,32065,21986,10079
310M200US16220,16220,2013,32665,22180,10485
310M200US16220,16220,2014,33323,20972,12351
310M200US16220,16220,2015,32564,20204,12360
310M300US16220,16220,2016,32059,20843,11216
3100000US16300,16300,2006,102007,74727,27280
3100000US16300,16300,2007,105615,77265,28350
3100000US16300,16300,2008,104111,77359,26752
3100000US16300,16300,2009,102761,76136,26625
310M100US16300,16300,2010,105963,78032,27931
310M100US16300,16300,2011,104757,79302,25455
310M100US16300,16300,2012,102818,76397,26421
310M200US16300,16300,2013,105035,77655,27380
310M200US16300,16300,2014,106799,80226,26573
310M200US16300,16300,2015,107586,78801,28785
310M300US16300,16300,2016,107867,80229,27638
3100000US16500,16500,2006,27230,20408,6822
3100000US16500,16500,2007,29130,21017,8113
3100000US16500,16500,2008,27039,18993,8046
3100000US16500,16500,2009,29677,21061,8616
310M100US16500,16500,2010,28142,20152,7990
310M100US16500,16500,2011,29829,20145,9684
310M100US16500,16500,2012,30134,20244,9890
310M200US16500,16500,2013,29040,19853,9187
310M200US16500,16500,2014,29969,20153,9816
310M200US16500,16500,2015,29078,20232,8846
310M300US16500,16500,2016,29509,20233,9276
3100000US16540,16540,2006,56815,42844,13971
3100000US16540,16540,2007,57049,41536,15513
3100000US16540,16540,2008,57090,40808,16282
3100000US16540,16540,2009,57289,42337,14952
310M100US16540,16540,2010,57533,42794,14739
310M100US16540,16540,2011,56999,41781,15218
310M100US16540,16540,2012,58515,41483,17032
310M200US16540,16540,2013,59145,43799,15346
310M200US16540,16540,2014,58565,39926,18639
310M200US16540,16540,2015,59486,42420,17066
310M300US16540,16540,2016,60492,42290,18202
3100000US16580,16580,2006,85813,52956,32857
3100000US16580,16580,2007,89248,52640,36608
3100000US16580,16580,2008,89513,51867,37646
3100000US16580,16580,2009,90123,51260,38863
310M100US16580,16580,2010,90783,52590,38193
310M100US16580,16580,2011,91581,52286,39295
310M100US16580,16580,2012,92073,53935,38138
310M200US16580,16580,2013,90474,53875,36599
310M200US16580,16580,2014,94306,55097,39209
310M200US16580,16580,2015,92268,53187,39081
310M300US16580,16580,2016,94941,54069,40872
3100000US16620,16620,2006,127563,95338,32225
3100000US16620,16620,2007,125996,93740,32256
3100000US16620,16620,2008,128267,93134,35133
3100000US16620,16620,2009,129442,96443,32999
310M100US16620,16620,2010,125628,93784,31844
310M100US16620,16620,2011,123724,91414,32310
310M100US16620,16620,2012,127153,94290,32863
310M200US16620,16620,2013,95251,67313,27938
310M200US16620,16620,2014,93385,65297,28088
310M200US16620,16620,2015,94533,65092,29441
310M300US16620,16620,2016,91529,63651,27878
310M100US16660,16660,2011,25248,17395,7853
310M100US16660,16660,2012,24957,16260,8697
310M200US16660,16660,2013,24692,15435,9257
310M200US16660,16660,2014,25076,16027,9049
310M200US16660,16660,2015,25262,16066,9196
310M300US16660,16660,2016,25989,16011,9978
3100000US16700,16700,2006,234389,156473,77916
3100000US16700,16700,2007,242907,162187,80720
3100000US16700,16700,2008,237004,163057,73947
3100000US16700,16700,2009,245978,159273,86705
310M100US16700,16700,2010,252574,165225,87349
310M100US16700,16700,2011,258454,171262,87192
310M100US16700,16700,2012,262131,166077,96054
310M200US16700,16700,2013,268003,170079,97924
310M200US16700,16700,2014,276509,177049,99460
310M200US16700,16700,2015,273722,179155,94567
310M300US16700,16700,2016,287362,188025,99337
3100000US16740,16740,2006,613645,420234,193411
3100000US16740,16740,2007,638709,429931,208778
3100000US16740,16740,2008,661392,451165,210227
3100000US16740,16740,2009,675535,451990,223545
310M100US16740,16740,2010,663300,445574,217726
310M100US16740,16740,2011,671191,443616,227575
310M100US16740,16740,2012,675362,434340,241022
310M200US16740,16740,2013,859709,558635,301074
310M200US16740,16740,2014,883281,570986,312295
310M200US16740,16740,2015,905696,585399,320297
310M300US16740,16740,2016,917897,594865,323032
3100000US16820,16820,2006,76170,49604,26566
3100000US16820,16820,2007,77680,50613,27067
3100000US16820,16820,2008,76392,50077,26315
3100000US16820,16820,2009,76010,50415,25595
310M100US16820,16820,2010,76764,48936,27828
310M100US16820,16820,2011,77621,50192,27429
310M100US16820,16820,2012,77795,49863,27932
310M200US16820,16820,2013,84595,56503,28092
310M200US16820,16820,2014,87139,53526,33613
310M200US16820,16820,2015,87949,57318,30631
310M300US16820,16820,2016,87091,54188,32903
3100000US16860,16860,2006,203599,141936,61663
3100000US16860,16860,2007,204531,141212,63319
3100000US16860,16860,2008,203326,143783,59543
3100000US16860,16860,2009,209486,143726,65760
310M100US16860,16860,2010,208995,143834,65161
310M100US16860,16860,2011,206421,140451,65970
310M100US16860,16860,2012,207794,138563,69231
310M200US16860,16860,2013,209304,140987,68317
310M200US16860,16860,2014,207829,137915,69914
310M200US16860,16860,2015,209340,140393,68947
310M300US16860,16860,2016,210802,143252,67550
3100000US16940,16940,2006,33463,23164,10299
3100000US16940,16940,2007,33261,22904,10357
3100000US16940,16940,2008,33025,23650,9375
3100000US16940,16940,2009,34945,24117,10828
310M100US16940,16940,2010,38389,25619,12770
310M100US16940,16940,2011,37687,25727,11960
310M100US16940,16940,2012,35245,23766,11479
310M200US16940,16940,2013,35785,24485,11300
310M200US16940,16940,2014,38705,26304,12401
310M200US16940,16940,2015,37740,24668,13072
310M300US16940,16940,2016,38181,25987,12194
3100000US16980,16980,2006,3385287,2328139,1057148
3100000US16980,16980,2007,3412058,2356612,1055446
3100000US16980,16980,2008,3421890,2334145,1087745
3100000US16980,16980,2009,3399708,2276724,1122984
310M100US16980,16980,2010,3415317,2260128,1155189
310M100US16980,16980,2011,3403363,2230462,1172901
310M100US16980,16980,2012,3426426,2221182,1205244
310M200US16980,16980,2013,3450331,2211699,1238632
310M200US16980,16980,2014,3442174,2202845,1239329
310M200US16980,16980,2015,3470993,2195149,1275844
310M300US16980,16980,2016,3491635,2213958,1277677
3100000US17020,17020,2006,85513,51211,34302
3100000US17020,17020,2007,85845,50554,35291
3100000US17020,17020,2008,86438,49878,36560
3100000US17020,17020,2009,84440,51838,32602
310M100US17020,17020,2010,84629,50325,34304
310M100US17020,17020,2011,83634,48746,34888
310M100US17020,17020,2012,85388,50752,34636
310M200US17020,17020,2013,85158,48961,36197
310M200US17020,17020,2014,85366,50643,34723
310M200US17020,17020,2015,85289,49074,36215
310M300US17020,17020,2016,85531,50565,34966
3100000US17060,17060,2006,26491,19316,7175
3100000US17060,17060,2007,26528,20494,6034
3100000US17060,17060,2008,26058,19083,6975
3100000US17060,17060,2009,26897,20275,6622
310M100US17060,17060,2010,27943,19127,8816
310M100US17060,17060,2011,28547,21036,7511
310M100US17060,17060,2012,27948,20500,7448
310M200US17060,17060,2013,28189,20483,7706
310M200US17060,17060,2014,27569,18354,9215
310M200US17060,17060,2015,28324,19772,8552
310M300US17060,17060,2016,28710,19521,9189
3100000US17140,17140,2006,801736,557971,243765
3100000US17140,17140,2007,808000,561223,246777
3100000US17140,17140,2008,814608,567728,246880
3100000US17140,17140,2009,816646,557021,259625
310M100US17140,17140,2010,811494,559261,252233
310M100US17140,17140,2011,805714,554054,251660
310M100US17140,17140,2012,825221,548390,276831
310M200US17140,17140,2013,822005,538676,283329
310M200US17140,17140,2014,829142,540460,288682
310M200US17140,17140,2015,832607,544289,288318
310M300US17140,17140,2016,841382,552290,289092
310M200US17200,17200,2013,89431,63515,25916
310M200US17200,17200,2014,89665,64227,25438
310M200US17200,17200,2015,89204,63779,25425
310M300US17200,17200,2016,85999,62845,23154
3100000US17220,17220,2006,36967,28080,8887
3100000US17220,17220,2007,37863,28331,9532
3100000US17220,17220,2008,38001,28456,9545
3100000US17220,17220,2009,37127,26613,10514
310M100US17220,17220,2010,37538,28642,8896
310M100US17220,17220,2011,35917,27940,7977
310M100US17220,17220,2012,37839,27997,9842
310M200US17220,17220,2013,36087,27093,8994
310M200US17220,17220,2014,36004,26510,9494
310M200US17220,17220,2015,35855,27979,7876
310M300US17220,17220,2016,36135,27166,8969
3100000US17300,17300,2006,91840,56844,34996
3100000US17300,17300,2007,98659,66343,32316
3100000US17300,17300,2008,97193,65016,32177
3100000US17300,17300,2009,100050,63675,36375
310M100US17300,17300,2010,99039,64754,34285
310M100US17300,17300,2011,100069,58931,41138
310M100US17300,17300,2012,101067,60121,40946
310M200US17300,17300,2013,96258,57247,39011
310M200US17300,17300,2014,97747,55545,42202
310M200US17300,17300,2015,101265,56971,44294
310M300US17300,17300,2016,100564,57901,42663
3100000US17340,17340,2006,25212,16167,9045
3100000US17340,17340,2007,23326,16763,6563
3100000US17340,17340,2008,24459,15574,8885
3100000US17340,17340,2009,26670,17747,8923
310M100US17340,17340,2010,24521,15970,8551
310M100US17340,17340,2011,28885,16839,12046
310M100US17340,17340,2012,26228,15542,10686
310M200US17340,17340,2013,26194,16595,9599
310M200US17340,17340,2014,27636,17872,9764
310M200US17340,17340,2015,26335,16846,9489
310M300US17340,17340,2016,24593,14713,9880
3100000US17420,17420,2006,43607,29195,14412
3100000US17420,17420,2007,43337,29674,13663
3100000US17420,17420,2008,43985,30102,13883
3100000US17420,17420,2009,44560,31492,13068
310M100US17420,17420,2010,43805,31335,12470
310M100US17420,17420,2011,44578,30267,14311
310M100US17420,17420,2012,46079,30259,15820
310M200US17420,17420,2013,46157,31884,14273
310M200US17420,17420,2014,44048,29958,14090
310M200US17420,17420,2015,46389,29072,17317
310M300US17420,17420,2016,47253,31687,15566
3100000US17460,17460,2006,835188,586276,248912
3100000US17460,17460,2007,835704,570541,265163
3100000US17460,17460,2008,837158,569009,268149
3100000US17460,17460,2009,838323,556535,281788
310M100US17460,17460,2010,840929,568859,272070
310M100US17460,17460,2011,844779,552802,291977
310M100US17460,17460,2012,839838,547601,292237
310M200US17460,17460,2013,844428,547584,296844
310M200US17460,17460,2014,848493,546272,302221
310M200US17460,17460,2015,849475,548250,301225
310M300US17460,17460,2016,851882,550706,301176
3100000US17620,17620,2009,21895,15977,5918
310M100US17620,17620,2010,26008,20926,5082
310M100US17620,17620,2011,25750,20393,5357
310M100US17620,17620,2012,24688,20484,4204
3100000US17660,17660,2006,51287,35656,15631
3100000US17660,17660,2007,53505,38842,14663
3100000US17660,17660,2008,53060,38261,14799
3100000US17660,17660,2009,54456,38902,15554
310M100US17660,17660,2010,55456,38782,16674
310M100US17660,17660,2011,56226,39788,16438
310M100US17660,17660,2012,55848,38505,17343
310M200US17660,17660,2013,55836,41538,14298
310M200US17660,17660,2014,56177,37243,18934
310M200US17660,17660,2015,58675,40992,17683
310M300US17660,17660,2016,58875,38344,20531
3100000US17780,17780,2006,74077,39482,34595
3100000US17780,17780,2007,75530,38856,36674
3100000US17780,17780,2008,75403,38492,36911
3100000US17780,17780,2009,77469,38630,38839
310M100US17780,17780,2010,81720,42331,39389
310M100US17780,17780,2011,79146,39689,39457
310M100US17780,17780,2012,82134,41977,40157
310M200US17780,17780,2013,85573,41630,43943
310M200US17780,17780,2014,89858,42843,47015
310M200US17780,17780,2015,90526,44840,45686
310M300US17780,17780,2016,91033,45941,45092
3100000US17820,17820,2006,228414,158385,70029
3100000US17820,17820,2007,226445,156257,70188
3100000US17820,17820,2008,229554,156067,73487
3100000US17820,17820,2009,236598,158551,78047
310M100US17820,17820,2010,244194,156758,87436
310M100US17820,17820,2011,247254,155949,91305
310M100US17820,17820,2012,247950,158240,89710
310M200US17820,17820,2013,250601,158907,91694
310M200US17820,17820,2014,255330,163050,92280
310M200US17820,17820,2015,261435,161617,99818
310M300US17820,17820,2016,267621,168763,98858
3100000US17860,17860,2006,66593,40204,26389
3100000US17860,17860,2007,67562,40133,27429
3100000US17860,17860,2008,67023,38036,28987
3100000US17860,17860,2009,69925,40861,29064
310M100US17860,17860,2010,67997,39793,28204
310M100US17860,17860,2011,66868,37653,29215
310M100US17860,17860,2012,69963,39892,30071
310M200US17860,17860,2013,67680,35977,31703
310M200US17860,17860,2014,67198,37296,29902
310M200US17860,17860,2015,69152,38582,30570
310M300US17860,17860,2016,68848,35682,33166
3100000US17900,17900,2006,270229,189513,80716
3100000US17900,17900,2007,278694,193388,85306
3100000US17900,17900,2008,279991,193608,86383
3100000US17900,17900,2009,285695,198713,86982
310M100US17900,17900,2010,293357,197654,95703
310M100US17900,17900,2011,295442,198952,96490
310M100US17900,17900,2012,294039,199959,94080
310M200US17900,17900,2013,296310,200023,96287
310M200US17900,17900,2014,298600,198062,100538
310M200US17900,17900,2015,302634,201505,101129
310M300US17900,17900,2016,309016,206513,102503
3100000US17940,17940,2006,31310,21793,9517
3100000US17940,17940,2007,31542,22855,8687
3100000US17940,17940,2008,33285,22976,10309
3100000US17940,17940,2009,33145,24395,8750
310M100US17940,17940,2010,31812,23040,8772
310M100US17940,17940,2011,31325,22254,9071
310M100US17940,17940,2012,31960,20545,11415
3100000US17980,17980,2006,108763,66036,42727
3100000US17980,17980,2007,109993,68656,41337
3100000US17980,17980,2008,111089,67979,43110
3100000US17980,17980,2009,111487,66474,45013
310M100US17980,17980,2010,108930,63539,45391
310M100US17980,17980,2011,108512,62126,46386
310M100US17980,17980,2012,110334,63361,46973
310M200US17980,17980,2013,110901,59599,51302
310M200US17980,17980,2014,113195,59500,53695
310M200US17980,17980,2015,112983,58983,54000
310M300US17980,17980,2016,113256,60350,52906
3100000US18020,18020,2006,27983,21204,6779
3100000US18020,18020,2007,27850,20435,7415
3100000US18020,18020,2008,29616,22577,7039
3100000US18020,18020,2009,28780,21083,7697
310M100US18020,18020,2010,31046,20877,10169
310M100US18020,18020,2011,29086,20914,8172
310M100US18020,18020,2012,29640,21126,8514
310M200US18020,18020,2013,30359,21087,9272
310M200US18020,18020,2014,31827,22224,9603
310M200US18020,18020,2015,31131,22165,8966
310M300US18020,18020,2016,31626,22236,9390
3100000US18140,18140,2006,679926,443041,236885
3100000US18140,18140,2007,684217,446646,237571
3100000US18140,18140,2008,690139,447486,242653
3100000US18140,18140,2009,693137,438253,254884
310M100US18140,18140,2010,707956,446235,261721
310M100US18140,18140,2011,715770,439634,276136
310M100US18140,18140,2012,719081,439245,279836
310M200US18140,18140,2013,750394,463918,286476
310M200US18140,18140,2014,764395,464118,300277
310M200US18140,18140,2015,772304,467291,305013
310M300US18140,18140,2016,779547,470962,308585
3100000US18180,18180,2006,57104,39716,17388
3100000US18180,18180,2007,55009,39986,15023
3100000US18180,18180,2008,56694,41164,15530
3100000US18180,18180,2009,55897,40634,15263
310M100US18180,18180,2010,57224,40121,17103
310M100US18180,18180,2011,57535,44013,13522
310M100US18180,18180,2012,57222,40203,17019
310M200US18180,18180,2013,55085,40069,15016
310M200US18180,18180,2014,57023,39761,17262
310M200US18180,18180,2015,55235,39274,15961
310M300US18180,18180,2016,57531,40295,17236
3100000US18260,18260,2006,40533,26582,13951
3100000US18260,18260,2007,41883,29042,12841
3100000US18260,18260,2008,38892,27494,11398
3100000US18260,18260,2009,40790,30180,10610
310M100US18260,18260,2010,41145,27924,13221
310M100US18260,18260,2011,42284,28059,14225
310M100US18260,18260,2012,41495,28220,13275
310M200US18260,18260,2013,43720,28487,15233
310M200US18260,18260,2014,42778,28129,14649
310M200US18260,18260,2015,43626,30082,13544
310M300US18260,18260,2016,45459,29571,15888
3100000US18300,18300,2006,28507,18818,9689
3100000US18300,18300,2007,28168,19015,9153
3100000US18300,18300,2008,28211,18808,9403
3100000US18300,18300,2009,27439,17684,9755
310M100US18300,18300,2010,25723,16549,9174
310M100US18300,18300,2011,27008,17737,9271
310M100US18300,18300,2012,24818,16581,8237
310M200US18300,18300,2013,26317,16830,9487
310M200US18300,18300,2014,25160,16015,9145
310M200US18300,18300,2015,26364,16486,9878
310M300US18300,18300,2016,25862,16823,9039
3100000US18500,18500,2006,38727,28546,10181
3100000US18500,18500,2007,38658,28117,10541
3100000US18500,18500,2008,38380,27789,10591
3100000US18500,18500,2009,41247,30324,10923
310M100US18500,18500,2010,41052,29582,11470
310M100US18500,18500,2011,41843,28967,12876
310M100US18500,18500,2012,41597,29102,12495
310M200US18500,18500,2013,41241,29519,11722
310M200US18500,18500,2014,41046,28071,12975
310M200US18500,18500,2015,39517,27481,12036
310M300US18500,18500,2016,38458,28003,10455
3100000US18580,18580,2006,149134,93224,55910
3100000US18580,18580,2007,150850,95203,55647
3100000US18580,18580,2008,150528,95156,55372
3100000US18580,18580,2009,152080,95887,56193
310M100US18580,18580,2010,154206,93749,60457
310M100US18580,18580,2011,152710,89986,62724
310M100US18580,18580,2012,156182,95131,61051
310M200US18580,18580,2013,160549,95962,64587
310M200US18580,18580,2014,160869,97032,63837
310M200US18580,18580,2015,161634,92693,68941
310M300US18580,18580,2016,161353,97308,64045
3100000US18700,18700,2006,32600,17897,14703
3100000US18700,18700,2007,32946,18624,14322
3100000US18700,18700,2008,33918,19663,14255
3100000US18700,18700,2009,33398,18631,14767
310M100US18700,18700,2010,32888,19430,13458
310M100US18700,18700,2011,33088,18586,14502
310M100US18700,18700,2012,33395,19227,14168
310M200US18700,18700,2013,33609,19247,14362
310M200US18700,18700,2014,33904,18509,15395
310M200US18700,18700,2015,35062,20401,14661
310M300US18700,18700,2016,34543,20217,14326
310M100US18880,18880,2010,70407,47047,23360
310M100US18880,18880,2011,70573,47160,23413
310M100US18880,18880,2012,75099,46720,28379
310M200US18880,18880,2013,98219,64036,34183
310M200US18880,18880,2014,95662,62531,33131
310M200US18880,18880,2015,102729,64647,38082
310M300US18880,18880,2016,103309,67582,35727
3100000US18980,18980,2006,30953,20712,10241
3100000US18980,18980,2007,31269,24269,7000
3100000US18980,18980,2008,30714,22421,8293
3100000US18980,18980,2009,31055,22578,8477
310M100US18980,18980,2010,29666,22316,7350
310M100US18980,18980,2011,31954,23942,8012
310M100US18980,18980,2012,31450,23792,7658
310M200US18980,18980,2013,32225,24380,7845
310M200US18980,18980,2014,30424,22670,7754
310M200US18980,18980,2015,30798,23054,7744
310M300US18980,18980,2016,30299,23306,6993
3100000US19060,19060,2006,41113,29748,11365
3100000US19060,19060,2007,40227,28034,12193
3100000US19060,19060,2008,39129,29044,10085
3100000US19060,19060,2009,40194,28400,11794
310M100US19060,19060,2010,40076,29423,10653
310M100US19060,19060,2011,39621,24545,15076
310M100US19060,19060,2012,39475,25071,14404
310M200US19060,19060,2013,37773,25421,12352
310M200US19060,19060,2014,40318,25598,14720
310M200US19060,19060,2015,39120,25702,13418
310M300US19060,19060,2016,38956,27543,11413
3100000US19100,19100,2006,2085819,1327280,758539
3100000US19100,19100,2007,2128648,1354752,773896
3100000US19100,19100,2008,2182455,1376668,805787
3100000US19100,19100,2009,2201105,1369201,831904
310M100US19100,19100,2010,2274493,1402368,872125
310M100US19100,19100,2011,2300151,1404696,895455
310M100US19100,19100,2012,2337076,1391558,945518
310M200US19100,19100,2013,2406092,1431527,974565
310M200US19100,19100,2014,2445239,1447277,997962
310M200US19100,19100,2015,2479995,1469868,1010127
310M300US19100,19100,2016,2538547,1499889,1038658
3100000US19140,19140,2006,44592,32460,12132
3100000US19140,19140,2007,46075,31548,14527
3100000US19140,19140,2008,47561,33155,14406
3100000US19140,19140,2009,45214,30489,14725
310M100US19140,19140,2010,48349,32910,15439
310M100US19140,19140,2011,48012,31274,16738
310M100US19140,19140,2012,48205,30894,17311
310M200US19140,19140,2013,48318,30309,18009
310M200US19140,19140,2014,50238,32211,18027
310M200US19140,19140,2015,48631,31424,17207
310M300US19140,19140,2016,49692,32003,17689
3100000US19180,19180,2006,32882,23454,9428
3100000US19180,19180,2007,32394,23188,9206
3100000US19180,19180,2008,33051,24220,8831
3100000US19180,19180,2009,31472,21555,9917
310M100US19180,19180,2010,31332,21883,9449
310M100US19180,19180,2011,31414,22040,9374
310M100US19180,19180,2012,31714,22154,9560
310M200US19180,19180,2013,31482,22679,8803
310M200US19180,19180,2014,31338,20550,10788
310M200US19180,19180,2015,30927,20726,10201
310M300US19180,19180,2016,31928,23154,8774
3100000US19260,19260,2006,46852,32504,14348
3100000US19260,19260,2007,44358,31061,13297
3100000US19260,19260,2008,45574,31841,13733
3100000US19260,19260,2009,45036,30049,14987
310M100US19260,19260,2010,45278,31895,13383
310M100US19260,19260,2011,43345,30083,13262
310M100US19260,19260,2012,45216,31171,14045
310M200US19260,19260,2013,44854,30307,14547
310M200US19260,19260,2014,45370,30635,14735
310M200US19260,19260,2015,45918,30153,15765
310M300US19260,19260,2016,43987,29025,14962
3100000US19300,19300,2006,70427,52418,18009
3100000US19300,19300,2007,69338,53739,15599
3100000US19300,19300,2008,68926,52759,16167
3100000US19300,19300,2009,74477,56323,18154
310M100US19300,19300,2010,68096,48864,19232
310M100US19300,19300,2011,74460,54247,20213
310M100US19300,19300,2012,77978,52497,25481
310M200US19300,19300,2013,70259,48841,21418
310M200US19300,19300,2014,71307,51657,19650
310M200US19300,19300,2015,72269,53232,19037
310M300US19300,19300,2016,76779,56144,20635
3100000US19340,19340,2006,153423,110139,43284
3100000US19340,19340,2007,151604,109314,42290
3100000US19340,19340,2008,155411,111527,43884
3100000US19340,19340,2009,155501,110190,45311
310M100US19340,19340,2010,154889,112332,42557
310M100US19340,19340,2011,154153,109488,44665
310M100US19340,19340,2012,155726,109533,46193
310M200US19340,19340,2013,153566,106276,47290
310M200US19340,19340,2014,153602,107079,46523
310M200US19340,19340,2015,155753,109619,46134
310M300US19340,19340,2016,153275,108654,44621
3100000US19380,19380,2006,340778,230036,110742
3100000US19380,19380,2007,339281,227232,112049
3100000US19380,19380,2008,338958,226055,112903
3100000US19380,19380,2009,340747,221719,119028
310M100US19380,19380,2010,342919,225536,117383
310M100US19380,19380,2011,344980,221358,123622
310M100US19380,19380,2012,341240,217144,124096
310M200US19380,19380,2013,323890,205925,117965
310M200US19380,19380,2014,327610,205057,122553
310M200US19380,19380,2015,330430,208163,122267
310M300US19380,19380,2016,328352,204398,123954
3100000US19460,19460,2006,59258,45441,13817
3100000US19460,19460,2007,59752,45300,14452
3100000US19460,19460,2008,59319,42410,16909
3100000US19460,19460,2009,60534,43717,16817
310M100US19460,19460,2010,57902,43286,14616
310M100US19460,19460,2011,58755,44287,14468
310M100US19460,19460,2012,59790,42718,17072
310M200US19460,19460,2013,60129,44203,15926
310M200US19460,19460,2014,58351,41960,16391
310M200US19460,19460,2015,60697,44395,16302
310M300US19460,19460,2016,57753,44349,13404
3100000US19500,19500,2006,46761,32988,13773
3100000US19500,19500,2007,45555,32809,12746
3100000US19500,19500,2008,45959,32455,13504
3100000US19500,19500,2009,45621,31499,14122
310M100US19500,19500,2010,45624,30870,14754
310M100US19500,19500,2011,43604,29317,14287
310M100US19500,19500,2012,46336,31433,14903
310M200US19500,19500,2013,44965,32038,12927
310M200US19500,19500,2014,44063,31375,12688
310M200US19500,19500,2015,44429,29990,14439
310M300US19500,19500,2016,44002,29489,14513
3100000US19660,19660,2006,203394,153472,49922
3100000US19660,19660,2007,200456,152394,48062
3100000US19660,19660,2008,199936,152888,47048
3100000US19660,19660,2009,192532,142129,50403
310M100US19660,19660,2010,190757,142542,48215
310M100US19660,19660,2011,190074,137768,52306
310M100US19660,19660,2012,197599,139167,58432
310M200US19660,19660,2013,235616,166880,68736
310M200US19660,19660,2014,237527,168855,68672
310M200US19660,19660,2015,248938,175233,73705
310M300US19660,19660,2016,255350,180204,75146
3100000US19740,19740,2006,945880,646194,299686
3100000US19740,19740,2007,953034,649942,303092
3100000US19740,19740,2008,968100,651546,316554
3100000US19740,19740,2009,973915,638885,335030
310M100US19740,19740,2010,1001253,648718,352535
310M100US19740,19740,2011,1007022,634148,372874
310M100US19740,19740,2012,1021036,637318,383718
310M200US19740,19740,2013,1035096,657099,377997
310M200US19740,19740,2014,1054371,657134,397237
310M200US19740,19740,2015,1075919,677167,398752
310M300US19740,19740,2016,1091571,696366,395205
3100000US19780,19780,2006,216526,159401,57125
3100000US19780,19780,2007,216569,160191,56378
3100000US19780,19780,2008,217834,158441,59393
3100000US19780,19780,2009,224540,158378,66162
310M100US19780,19780,2010,223767,161474,62293
310M100US19780,19780,2011,222738,158981,63757
310M100US19780,19780,2012,230228,163424,66804
310M200US19780,19780,2013,233644,161399,72245
310M200US19780,19780,2014,235515,160993,74522
310M200US19780,19780,2015,242022,165474,76548
310M300US19780,19780,2016,245643,170494,75149
3100000US19820,19820,2006,1689855,1261188,428667
3100000US19820,19820,2007,1678805,1247704,431101
3100000US19820,19820,2008,1654052,1208824,445228
3100000US19820,19820,2009,1649257,1188048,461209
310M100US19820,19820,2010,1655395,1178371,477024
310M100US19820,19820,2011,1635840,1146397,489443
310M100US19820,19820,2012,1645835,1136407,509428
310M200US19820,19820,2013,1658085,1137245,520840
310M200US19820,19820,2014,1654584,1125408,529176
310M200US19820,19820,2015,1674251,1139107,535144
310M300US19820,19820,2016,1689859,1142608,547251
3100000US20020,20020,2006,52234,37688,14546
3100000US20020,20020,2007,52855,38572,14283
3100000US20020,20020,2008,53144,38455,14689
3100000US20020,20020,2009,54976,38138,16838
310M100US20020,20020,2010,58581,38468,20113
310M100US20020,20020,2011,57470,39610,17860
310M100US20020,20020,2012,56259,38548,17711
310M200US20020,20020,2013,57990,39602,18388
310M200US20020,20020,2014,55998,38295,17703
310M200US20020,20020,2015,55973,37187,18786
310M300US20020,20020,2016,56133,38743,17390
3100000US20100,20100,2006,55424,40728,14696
3100000US20100,20100,2007,57430,40510,16920
3100000US20100,20100,2008,57438,42332,15106
3100000US20100,20100,2009,58053,43524,14529
310M100US20100,20100,2010,54896,41417,13479
310M100US20100,20100,2011,56799,39697,17102
310M100US20100,20100,2012,59499,42614,16885
310M200US20100,20100,2013,62053,44636,17417
310M200US20100,20100,2014,61270,41144,20126
310M200US20100,20100,2015,62477,42329,20148
310M300US20100,20100,2016,64452,43176,21276
3100000US20180,20180,2006,33408,25432,7976
3100000US20180,20180,2007,33443,25768,7675
3100000US20180,20180,2008,32393,24556,7837
3100000US20180,20180,2009,32956,25271,7685
310M100US20180,20180,2010,31050,23728,7322
310M100US20180,20180,2011,32709,25682,7027
310M100US20180,20180,2012,32186,24985,7201
310M200US20180,20180,2013,30922,23411,7511
310M200US20180,20180,2014,31784,24788,6996
310M200US20180,20180,2015,30929,23174,7755
310M300US20180,20180,2016,29061,22384,6677
3100000US20220,20220,2006,36861,27045,9816
3100000US20220,20220,2007,36847,27486,9361
3100000US20220,20220,2008,36773,27628,9145
3100000US20220,20220,2009,37577,28572,9005
310M100US20220,20220,2010,37177,27610,9567
310M100US20220,20220,2011,37646,27949,9697
310M100US20220,20220,2012,37726,27254,10472
310M200US20220,20220,2013,36801,26069,10732
310M200US20220,20220,2014,38824,28204,10620
310M200US20220,20220,2015,37784,27154,10630
310M300US20220,20220,2016,37710,27960,9750
3100000US20260,20260,2006,114665,87504,27161
3100000US20260,20260,2007,119962,87420,32542
3100000US20260,20260,2008,118337,84896,33441
3100000US20260,20260,2009,119840,84838,35002
310M100US20260,20260,2010,121010,86181,34829
310M100US20260,20260,2011,116198,83760,32438
310M100US20260,20260,2012,116531,82361,34170
310M200US20260,20260,2013,115589,82301,33288
310M200US20260,20260,2014,116768,83732,33036
310M200US20260,20260,2015,116212,83801,32411
310M300US20260,20260,2016,116967,82453,34514
3100000US20380,20380,2006,36269,24602,11667
3100000US20380,20380,2007,40156,25707,14449
3100000US20380,20380,2008,40741,28095,12646
3100000US20380,20380,2009,40637,28515,12122
310M100US20380,20380,2010,38631,25984,12647
310M100US20380,20380,2011,41582,26626,14956
310M100US20380,20380,2012,41208,28721,12487
310M200US20380,20380,2013,42464,28579,13885
310M200US20380,20380,2014,44153,26501,17652
310M200US20380,20380,2015,43725,28388,15337
310M300US20380,20380,2016,43960,27637,16323
3100000US20500,20500,2006,185625,112595,73030
3100000US20500,20500,2007,189615,115794,73821
3100000US20500,20500,2008,194357,117763,76594
3100000US20500,20500,2009,197618,123417,74201
310M100US20500,20500,2010,198793,120634,78159
310M100US20500,20500,2011,203088,122498,80590
310M100US20500,20500,2012,207572,123227,84345
310M200US20500,20500,2013,209290,123933,85357
310M200US20500,20500,2014,213163,124954,88209
310M200US20500,20500,2015,215294,125502,89792
310M300US20500,20500,2016,217853,130773,87080
3100000US20620,20620,2006,42365,31346,11019
3100000US20620,20620,2007,40823,31646,9177
3100000US20620,20620,2008,41660,29331,12329
3100000US20620,20620,2009,41737,32603,9134
310M100US20620,20620,2010,42506,30815,11691
310M100US20620,20620,2011,42430,30479,11951
310M100US20620,20620,2012,42499,29098,13401
3100000US20700,20700,2006,58021,47079,10942
3100000US20700,20700,2007,60352,46483,13869
3100000US20700,20700,2008,60786,47537,13249
3100000US20700,20700,2009,59323,47339,11984
310M100US20700,20700,2010,58234,48140,10094
310M100US20700,20700,2011,57527,46015,11512
310M100US20700,20700,2012,57561,44318,13243
310M200US20700,20700,2013,58496,45132,13364
310M200US20700,20700,2014,54404,42457,11947
310M200US20700,20700,2015,55681,43067,12614
310M300US20700,20700,2016,57284,43312,13972
3100000US20740,20740,2006,63237,45009,18228
3100000US20740,20740,2007,61747,43190,18557
3100000US20740,20740,2008,63003,44100,18903
3100000US20740,20740,2009,62577,41792,20785
310M100US20740,20740,2010,63436,42882,20554
310M100US20740,20740,2011,64922,43207,21715
310M100US20740,20740,2012,64765,42828,21937
310M200US20740,20740,2013,64494,43669,20825
310M200US20740,20740,2014,65392,41028,24364
310M200US20740,20740,2015,63854,44058,19796
310M300US20740,20740,2016,66866,43994,22872
3100000US20940,20940,2006,45204,27196,18008
3100000US20940,20940,2007,46312,22774,23538
3100000US20940,20940,2008,46834,25739,21095
3100000US20940,20940,2009,48540,28596,19944
310M100US20940,20940,2010,48206,27947,20259
310M100US20940,20940,2011,48790,27172,21618
310M100US20940,20940,2012,46747,26517,20230
310M200US20940,20940,2013,47430,25644,21786
310M200US20940,20940,2014,43635,24760,18875
310M200US20940,20940,2015,45158,25428,19730
310M300US20940,20940,2016,44855,27250,17605
310M100US21020,21020,2012,24019,17158,6861
310M200US21020,21020,2013,22611,14746,7865
310M200US21020,21020,2014,23930,15770,8160
310M200US21020,21020,2015,23077,15750,7327
310M300US21020,21020,2016,23009,13628,9381
3100000US21060,21060,2006,42433,28559,13874
3100000US21060,21060,2007,40640,28165,12475
3100000US21060,21060,2008,45145,30066,15079
3100000US21060,21060,2009,43588,27526,16062
310M100US21060,21060,2010,44911,29867,15044
310M100US21060,21060,2011,43295,27977,15318
310M100US21060,21060,2012,44998,28118,16880
310M200US21060,21060,2013,56888,36139,20749
310M200US21060,21060,2014,54612,35992,18620
310M200US21060,21060,2015,56899,37213,19686
310M300US21060,21060,2016,56261,37094,19167
3100000US21140,21140,2006,70726,50014,20712
3100000US21140,21140,2007,71357,49742,21615
3100000US21140,21140,2008,70908,51716,19192
3100000US21140,21140,2009,69058,51689,17369
310M100US21140,21140,2010,67959,48734,19225
310M100US21140,21140,2011,70795,51850,18945
310M100US21140,21140,2012,70857,47685,23172
310M200US21140,21140,2013,71056,49236,21820
310M200US21140,21140,2014,70636,48434,22202
310M200US21140,21140,2015,68498,47284,21214
310M300US21140,21140,2016,72487,48403,24084
3100000US21300,21300,2006,34669,23336,11333
3100000US21300,21300,2007,34726,23485,11241
3100000US21300,21300,2008,34853,24117,10736
3100000US21300,21300,2009,36204,24017,12187
310M100US21300,21300,2010,35534,23848,11686
310M100US21300,21300,2011,35644,23431,12213
310M100US21300,21300,2012,34867,24469,10398
310M200US21300,21300,2013,35838,24160,11678
310M200US21300,21300,2014,34617,23747,10870
310M200US21300,21300,2015,34546,24556,9990
310M300US21300,21300,2016,34418,22271,12147
3100000US21340,21340,2006,229911,147670,82241
3100000US21340,21340,2007,231381,150015,81366
3100000US21340,21340,2008,237200,156406,80794
3100000US21340,21340,2009,241699,148333,93366
310M100US21340,21340,2010,248770,156624,92146
310M100US21340,21340,2011,257285,155801,101484
310M100US21340,21340,2012,260645,158861,101784
310M200US21340,21340,2013,259580,158182,101398
310M200US21340,21340,2014,256548,157847,98701
310M200US21340,21340,2015,261529,160929,100600
310M300US21340,21340,2016,268172,161045,107127
310M300US21420,21420,2016,24859,15599,9260
3100000US21460,21460,2006,38091,24349,13742
3100000US21460,21460,2007,38712,24671,14041
3100000US21460,21460,2008,39490,24981,14509
3100000US21460,21460,2009,37870,24297,13573
310M100US21460,21460,2010,38206,25782,12424
310M100US21460,21460,2011,37470,24764,12706
310M100US21460,21460,2012,40794,26307,14487
3100000US21500,21500,2006,107874,74100,33774
3100000US21500,21500,2007,105632,75070,30562
3100000US21500,21500,2008,106435,73786,32649
3100000US21500,21500,2009,108457,75682,32775
310M100US21500,21500,2010,109388,73009,36379
310M100US21500,21500,2011,109138,72287,36851
310M100US21500,21500,2012,109973,71965,38008
310M200US21500,21500,2013,110733,75439,35294
310M200US21500,21500,2014,108655,72068,36587
310M200US21500,21500,2015,110138,70551,39587
310M300US21500,21500,2016,109705,72423,37282
3100000US21660,21660,2006,137601,84074,53527
3100000US21660,21660,2007,138374,87679,50695
3100000US21660,21660,2008,142951,87136,55815
3100000US21660,21660,2009,140782,83643,57139
310M100US21660,21660,2010,144923,87193,57730
310M100US21660,21660,2011,145781,82365,63416
310M100US21660,21660,2012,146327,85881,60446
310M200US21660,21660,2013,144166,86435,57731
310M200US21660,21660,2014,145732,86197,59535
310M200US21660,21660,2015,146602,85460,61142
310M300US21660,21660,2016,147712,87013,60699
3100000US21700,21700,2006,52660,28751,23909
3100000US21700,21700,2007,51902,30514,21388
3100000US21700,21700,2008,52979,28623,24356
3100000US21700,21700,2009,52316,29092,23224
310M100US21700,21700,2010,54980,31560,23420
310M100US21700,21700,2011,51183,28459,22724
310M100US21700,21700,2012,52241,28072,24169
310M200US21700,21700,2013,53191,28950,24241
310M200US21700,21700,2014,53195,28681,24514
310M200US21700,21700,2015,53553,29809,23744
310M300US21700,21700,2016,54230,31645,22585
3100000US21780,21780,2006,142463,104834,37629
3100000US21780,21780,2007,142027,101171,40856
3100000US21780,21780,2008,146258,102851,43407
3100000US21780,21780,2009,142331,99307,43024
310M100US21780,21780,2010,142984,102299,40685
310M100US21780,21780,2011,142972,101372,41600
310M100US21780,21780,2012,145212,100683,44529
310M200US21780,21780,2013,124343,87263,37080
310M200US21780,21780,2014,125439,84835,40604
310M200US21780,21780,2015,124936,83162,41774
310M300US21780,21780,2016,128277,86828,41449
3100000US21820,21820,2006,27986,17137,10849
3100000US21820,21820,2007,33673,19328,14345
3100000US21820,21820,2008,32559,20234,12325
3100000US21820,21820,2009,31169,20054,11115
310M100US21820,21820,2010,37413,21607,15806
310M100US21820,21820,2011,37016,21497,15519
310M100US21820,21820,2012,35944,21448,14496
310M200US21820,21820,2013,34056,20807,13249
310M200US21820,21820,2014,35692,20183,15509
310M200US21820,21820,2015,35475,20287,15188
310M300US21820,21820,2016,33770,21049,12721
3100000US21940,21940,2006,24713,20175,4538
3100000US21940,21940,2007,23508,18246,5262
3100000US21940,21940,2008,23715,17013,6702
3100000US21940,21940,2009,23540,17826,5714
310M100US21940,21940,2010,26293,19428,6865
310M100US21940,21940,2011,25619,19228,6391
310M100US21940,21940,2012,23605,17675,5930
3100000US22020,22020,2006,80840,48427,32413
3100000US22020,22020,2007,81363,47095,34268
3100000US22020,22020,2008,84272,49447,34825
3100000US22020,22020,2009,84330,48330,36000
310M100US22020,22020,2010,86373,48249,38124
310M100US22020,22020,2011,87929,51687,36242
310M100US22020,22020,2012,89002,51250,37752
310M200US22020,22020,2013,90959,50339,40620
310M200US22020,22020,2014,92345,53892,38453
310M200US22020,22020,2015,96142,52392,43750
310M300US22020,22020,2016,99968,55018,44950
310M200US22060,22060,2013,22361,17620,4741
310M200US22060,22060,2014,22933,17642,5291
310M200US22060,22060,2015,22745,16334,6411
310M300US22060,22060,2016,22895,16961,5934
310M100US22100,22100,2010,24466,16349,8117
310M100US22100,22100,2011,25194,14807,10387
310M100US22100,22100,2012,24023,15779,8244
310M200US22100,22100,2013,24435,16839,7596
310M200US22100,22100,2014,24915,16524,8391
310M200US22100,22100,2015,24741,17138,7603
310M300US22100,22100,2016,24350,16243,8107
3100000US22140,22140,2006,38559,28415,10144
3100000US22140,22140,2007,39496,29014,10482
3100000US22140,22140,2008,39861,29525,10336
3100000US22140,22140,2009,39609,30792,8817
310M100US22140,22140,2010,41703,29328,12375
310M100US22140,22140,2011,42224,32233,9991
310M100US22140,22140,2012,40025,29805,10220
310M200US22140,22140,2013,37847,28181,9666
310M200US22140,22140,2014,40378,28289,12089
310M200US22140,22140,2015,43030,30694,12336
310M300US22140,22140,2016,43093,30574,12519
3100000US22180,22180,2006,132591,80732,51859
3100000US22180,22180,2007,129458,80366,49092
3100000US22180,22180,2008,132566,81530,51036
3100000US22180,22180,2009,132109,74607,57502
310M100US22180,22180,2010,133054,78234,54820
310M100US22180,22180,2011,135555,77387,58168
310M100US22180,22180,2012,139404,77113,62291
310M200US22180,22180,2013,142827,74880,67947
310M200US22180,22180,2014,140204,74544,65660
310M200US22180,22180,2015,137158,71534,65624
310M300US22180,22180,2016,141972,76271,65701
3100000US22220,22220,2006,160511,104338,56173
3100000US22220,22220,2007,160013,105597,54416
3100000US22220,22220,2008,162875,104356,58519
3100000US22220,22220,2009,165413,106459,58954
310M100US22220,22220,2010,170006,108452,61554
310M100US22220,22220,2011,177663,109273,68390
310M100US22220,22220,2012,179264,112170,67094
310M200US22220,22220,2013,178227,110806,67421
310M200US22220,22220,2014,182570,112614,69956
310M200US22220,22220,2015,190860,115310,75550
310M300US22220,22220,2016,196775,117167,79608
3100000US22300,22300,2006,31334,22593,8741
3100000US22300,22300,2007,31525,24088,7437
3100000US22300,22300,2008,32245,21892,10353
3100000US22300,22300,2009,32627,22863,9764
310M100US22300,22300,2010,30198,21030,9168
310M100US22300,22300,2011,29732,21079,8653
310M100US22300,22300,2012,30064,21759,8305
310M200US22300,22300,2013,31732,21504,10228
310M200US22300,22300,2014,31747,21779,9968
310M200US22300,22300,2015,31389,21976,9413
310M300US22300,22300,2016,31693,20702,10991
3100000US22380,22380,2006,43189,26154,17035
3100000US22380,22380,2007,43142,27678,15464
3100000US22380,22380,2008,46500,28834,17666
3100000US22380,22380,2009,44132,25648,18484
310M100US22380,22380,2010,44276,27265,17011
310M100US22380,22380,2011,44826,27522,17304
310M100US22380,22380,2012,46366,27917,18449
310M200US22380,22380,2013,49002,27914,21088
310M200US22380,22380,2014,46919,28322,18597
310M200US22380,22380,2015,45911,28050,17861
310M300US22380,22380,2016,47408,28464,18944
3100000US22420,22420,2006,177191,128273,48918
3100000US22420,22420,2007,170767,125969,44798
3100000US22420,22420,2008,169002,118063,50939
3100000US22420,22420,2009,169776,119297,50479
310M100US22420,22420,2010,166539,116438,50101
310M100US22420,22420,2011,163473,113523,49950
310M100US22420,22420,2012,166225,115536,50689
310M200US22420,22420,2013,163740,115429,48311
310M200US22420,22420,2014,167096,109763,57333
310M200US22420,22420,2015,163488,115325,48163
310M300US22420,22420,2016,167171,113681,53490
3100000US22500,22500,2006,72367,51233,21134
3100000US22500,22500,2007,73691,50487,23204
3100000US22500,22500,2008,75652,53566,22086
3100000US22500,22500,2009,75679,53298,22381
310M100US22500,22500,2010,79218,52344,26874
310M100US22500,22500,2011,77239,53407,23832
310M100US22500,22500,2012,77878,52194,25684
310M200US22500,22500,2013,77550,49514,28036
310M200US22500,22500,2014,77815,52558,25257
310M200US22500,22500,2015,79914,52231,27683
310M300US22500,22500,2016,76117,54376,21741
3100000US22520,22520,2006,57616,43629,13987
3100000US22520,22520,2007,59650,42104,17546
3100000US22520,22520,2008,59855,44432,15423
3100000US22520,22520,2009,59509,42065,17444
310M100US22520,22520,2010,60910,43370,17540
310M100US22520,22520,2011,61561,44382,17179
310M100US22520,22520,2012,58960,40981,17979
310M200US22520,22520,2013,61383,42154,19229
310M200US22520,22520,2014,61239,41912,19327
310M200US22520,22520,2015,60663,42349,18314
310M300US22520,22520,2016,59676,42358,17318
3100000US22540,22540,2006,38722,28769,9953
3100000US22540,22540,2007,39612,28603,11009
3100000US22540,22540,2008,39555,29696,9859
3100000US22540,22540,2009,41234,29267,11967
310M100US22540,22540,2010,40736,29180,11556
310M100US22540,22540,2011,41277,28849,12428
310M100US22540,22540,2012,41191,29114,12077
310M200US22540,22540,2013,41202,29355,11847
310M200US22540,22540,2014,41938,29750,12188
310M200US22540,22540,2015,40295,29884,10411
310M300US22540,22540,2016,40815,29382,11433
310M100US22580,22580,2010,26818,19340,7478
310M100US22580,22580,2011,26944,19283,7661
310M100US22580,22580,2012,27506,20453,7053
310M200US22580,22580,2013,26213,17959,8254
310M200US22580,22580,2014,25805,19134,6671
310M200US22580,22580,2015,25745,18204,7541
310M300US22580,22580,2016,26982,19439,7543
3100000US22660,22660,2006,113140,75149,37991
3100000US22660,22660,2007,112848,78737,34111
3100000US22660,22660,2008,118483,79858,38625
3100000US22660,22660,2009,117719,77688,40031
310M100US22660,22660,2010,117812,78594,39218
310M100US22660,22660,2011,121911,78924,42987
310M100US22660,22660,2012,124031,79039,44992
310M200US22660,22660,2013,123877,80084,43793
310M200US22660,22660,2014,125165,78964,46201
310M200US22660,22660,2015,129210,83338,45872
310M300US22660,22660,2016,131407,83795,47612
3100000US22840,22840,2006,24321,18727,5594
3100000US22840,22840,2007,25102,18929,6173
3100000US22840,22840,2008,24481,18326,6155
3100000US22840,22840,2009,24297,18793,5504
310M100US22840,22840,2010,25738,20516,5222
310M100US22840,22840,2011,27139,21897,5242
310M100US22840,22840,2012,23776,17705,6071
310M300US22840,22840,2016,25383,18185,7198
3100000US22900,22900,2006,106701,74641,32060
3100000US22900,22900,2007,110305,73237,37068
3100000US22900,22900,2008,106473,72237,34236
3100000US22900,22900,2009,111587,77496,34091
310M100US22900,22900,2010,112468,79118,33350
310M100US22900,22900,2011,111961,76073,35888
310M100US22900,22900,2012,116089,79293,36796
310M200US22900,22900,2013,107030,71417,35613
310M200US22900,22900,2014,106099,72859,33240
310M200US22900,22900,2015,107375,72474,34901
310M300US22900,22900,2016,107196,69517,37679
3100000US23020,23020,2006,76767,52475,24292
3100000US23020,23020,2007,73559,49361,24198
3100000US23020,23020,2008,73078,48487,24591
3100000US23020,23020,2009,73316,49674,23642
3100000US23060,23060,2006,159465,115234,44231
3100000US23060,23060,2007,159757,116364,43393
3100000US23060,23060,2008,160814,117972,42842
3100000US23060,23060,2009,160046,115130,44916
310M100US23060,23060,2010,160275,114162,46113
310M100US23060,23060,2011,160481,114578,45903
310M100US23060,23060,2012,162645,115637,47008
310M200US23060,23060,2013,166620,116413,50207
310M200US23060,23060,2014,163139,115324,47815
310M200US23060,23060,2015,165857,115231,50626
310M300US23060,23060,2016,167408,115101,52307
3100000US23180,23180,2006,29427,20448,8979
3100000US23180,23180,2007,29564,20746,8818
3100000US23180,23180,2008,30068,20571,9497
3100000US23180,23180,2009,28736,18834,9902
310M100US23180,23180,2010,28939,18390,10549
310M100US23180,23180,2011,28947,19732,9215
310M100US23180,23180,2012,30265,19809,10456
310M200US23180,23180,2013,29443,18332,11111
310M200US23180,23180,2014,29797,20506,9291
310M200US23180,23180,2015,29262,20083,9179
310M300US23180,23180,2016,29694,18706,10988
3100000US23420,23420,2006,277256,152363,124893
3100000US23420,23420,2007,280493,157007,123486
3100000US23420,23420,2008,278964,149799,129165
3100000US23420,23420,2009,280846,152504,128342
310M100US23420,23420,2010,284690,154283,130407
310M100US23420,23420,2011,286255,155609,130646
310M100US23420,23420,2012,292280,150354,141926
310M200US23420,23420,2013,293517,152766,140751
310M200US23420,23420,2014,297993,152699,145294
310M200US23420,23420,2015,304209,158419,145790
310M300US23420,23420,2016,303216,160427,142789
3100000US23460,23460,2006,43335,31446,11889
3100000US23460,23460,2007,43237,31327,11910
3100000US23460,23460,2008,41829,29199,12630
3100000US23460,23460,2009,41422,30856,10566
310M100US23460,23460,2010,39731,29389,10342
310M100US23460,23460,2011,40443,29577,10866
310M100US23460,23460,2012,39031,26132,12899
310M200US23460,23460,2013,40135,28911,11224
310M200US23460,23460,2014,39714,27078,12636
310M200US23460,23460,2015,39332,29301,10031
310M300US23460,23460,2016,38766,27766,11000
3100000US23540,23540,2006,101514,56139,45375
3100000US23540,23540,2007,101041,57740,43301
3100000US23540,23540,2008,103311,59172,44139
3100000US23540,23540,2009,100866,56653,44213
310M100US23540,23540,2010,100329,57607,42722
310M100US23540,23540,2011,102149,52477,49672
310M100US23540,23540,2012,99542,56672,42870
310M200US23540,23540,2013,104294,55438,48856
310M200US23540,23540,2014,103619,56197,47422
310M200US23540,23540,2015,102219,56734,45485
310M300US23540,23540,2016,100985,55401,45584
3100000US23580,23580,2006,54423,38420,16003
3100000US23580,23580,2007,56616,40435,16181
3100000US23580,23580,2008,57623,39674,17949
3100000US23580,23580,2009,60021,42033,17988
310M100US23580,23580,2010,60969,40295,20674
310M100US23580,23580,2011,60043,42368,17675
310M100US23580,23580,2012,60500,39933,20567
310M200US23580,23580,2013,60937,38270,22667
310M200US23580,23580,2014,63383,43072,20311
310M200US23580,23580,2015,63989,41282,22707
310M300US23580,23580,2016,62038,40592,21446
3100000US23660,23660,2006,28593,19911,8682
3100000US23660,23660,2007,28186,19957,8229
3100000US23660,23660,2008,28579,18350,10229
3100000US23660,23660,2009,27870,19613,8257
310M100US23660,23660,2010,28599,19389,9210
310M100US23660,23660,2011,28177,19466,8711
310M100US23660,23660,2012,28631,19577,9054
3100000US23700,23700,2006,20283,15657,4626
3100000US23700,23700,2007,18004,13272,4732
3100000US23700,23700,2008,18628,13217,5411
3100000US23700,23700,2009,16510,11760,4750
310M100US23700,23700,2010,17100,12132,4968
310M100US23700,23700,2011,16949,12067,4882
310M100US23700,23700,2012,18200,13315,4885
310M200US23700,23700,2013,18046,13741,4305
310M200US23700,23700,2014,18148,13093,5055
310M200US23700,23700,2015,19735,14209,5526
310M300US23700,23700,2016,20061,13041,7020
3100000US23900,23900,2006,37113,29463,7650
3100000US23900,23900,2007,37635,29045,8590
3100000US23900,23900,2008,37726,28866,8860
3100000US23900,23900,2009,39040,29533,9507
310M100US23900,23900,2010,37831,28949,8882
310M100US23900,23900,2011,38006,28880,9126
310M100US23900,23900,2012,38102,29549,8553
310M200US23900,23900,2013,37242,29065,8177
310M200US23900,23900,2014,38748,29094,9654
310M200US23900,23900,2015,38459,30271,8188
310M300US23900,23900,2016,38125,29720,8405
3100000US24020,24020,2006,52687,36197,16490
3100000US24020,24020,2007,52100,37368,14732
3100000US24020,24020,2008,53089,35830,17259
3100000US24020,24020,2009,53113,38895,14218
310M100US24020,24020,2010,52974,38155,14819
310M100US24020,24020,2011,52159,37177,14982
310M100US24020,24020,2012,51781,37987,13794
310M200US24020,24020,2013,51414,36104,15310
310M200US24020,24020,2014,49937,36027,13910
310M200US24020,24020,2015,48814,34836,13978
310M300US24020,24020,2016,51614,36786,14828
310M200US24060,24060,2013,25785,17310,8475
310M200US24060,24060,2014,26927,17813,9114
310M200US24060,24060,2015,29543,18614,10929
310M300US24060,24060,2016,27781,18299,9482
3100000US24140,24140,2006,43813,29074,14739
3100000US24140,24140,2007,44303,29225,15078
3100000US24140,24140,2008,45195,28540,16655
3100000US24140,24140,2009,45474,27084,18390
310M100US24140,24140,2010,47759,30098,17661
310M100US24140,24140,2011,48584,29746,18838
310M100US24140,24140,2012,47554,28195,19359
310M200US24140,24140,2013,46834,26367,20467
310M200US24140,24140,2014,46281,26809,19472
310M200US24140,24140,2015,47490,29220,18270
310M300US24140,24140,2016,47240,27626,19614
3100000US24220,24220,2006,39310,24269,15041
3100000US24220,24220,2007,39293,24509,14784
3100000US24220,24220,2008,38699,23946,14753
3100000US24220,24220,2009,40036,22245,17791
310M100US24220,24220,2010,39993,24065,15928
310M100US24220,24220,2011,39271,23149,16122
310M100US24220,24220,2012,40954,22930,18024
310M200US24220,24220,2013,40982,23449,17533
310M200US24220,24220,2014,41882,24274,17608
310M200US24220,24220,2015,42166,23229,18937
310M300US24220,24220,2016,41827,23822,18005
3100000US24260,24260,2006,26379,17690,8689
3100000US24260,24260,2007,26666,17791,8875
3100000US24260,24260,2008,27370,18817,8553
3100000US24260,24260,2009,27577,18689,8888
310M100US24260,24260,2010,28448,19889,8559
310M100US24260,24260,2011,28023,18402,9621
310M100US24260,24260,2012,28433,19822,8611
310M200US24260,24260,2013,31723,21366,10357
310M200US24260,24260,2014,32187,21415,10772
310M200US24260,24260,2015,31703,20507,11196
310M300US24260,24260,2016,32945,21426,11519
3100000US24300,24300,2006,53617,37710,15907
3100000US24300,24300,2007,55033,40025,15008
3100000US24300,24300,2008,56994,39652,17342
3100000US24300,24300,2009,56448,42046,14402
310M100US24300,24300,2010,57311,41541,15770
310M100US24300,24300,2011,59770,42723,17047
310M100US24300,24300,2012,58779,41706,17073
310M200US24300,24300,2013,58466,39620,18846
310M200US24300,24300,2014,59703,38962,20741
310M200US24300,24300,2015,59066,39572,19494
310M300US24300,24300,2016,60188,38483,21705
3100000US24340,24340,2006,289147,214500,74647
3100000US24340,24340,2007,289645,214525,75120
3100000US24340,24340,2008,286882,214176,72706
3100000US24340,24340,2009,286316,213449,72867
310M100US24340,24340,2010,292388,213525,78863
310M100US24340,24340,2011,292195,211077,81118
310M100US24340,24340,2012,294081,209558,84523
310M200US24340,24340,2013,370818,267221,103597
310M200US24340,24340,2014,375683,267143,108540
310M200US24340,24340,2015,383194,276377,106817
310M300US24340,24340,2016,384790,278206,106584
3100000US24420,24420,2006,33531,24115,9416
3100000US24420,24420,2007,33947,23591,10356
3100000US24420,24420,2008,34124,22772,11352
3100000US24420,24420,2009,34735,23141,11594
310M100US24420,24420,2010,34099,21818,12281
310M100US24420,24420,2011,34502,22506,11996
310M100US24420,24420,2012,34048,21772,12276
310M200US24420,24420,2013,34517,22793,11724
310M200US24420,24420,2014,33486,21896,11590
310M200US24420,24420,2015,35918,23566,12352
310M300US24420,24420,2016,35439,22069,13370
3100000US24500,24500,2006,32059,21550,10509
3100000US24500,24500,2007,32130,21216,10914
3100000US24500,24500,2008,33277,22288,10989
3100000US24500,24500,2009,32752,22533,10219
310M100US24500,24500,2010,33053,22296,10757
310M100US24500,24500,2011,32187,21605,10582
310M100US24500,24500,2012,33471,20415,13056
310M200US24500,24500,2013,34492,22116,12376
310M200US24500,24500,2014,34018,21699,12319
310M200US24500,24500,2015,34375,21025,13350
310M300US24500,24500,2016,33759,21438,12321
3100000US24540,24540,2006,81059,57285,23774
3100000US24540,24540,2007,85157,59737,25420
3100000US24540,24540,2008,86163,59870,26293
3100000US24540,24540,2009,86083,60567,25516
310M100US24540,24540,2010,89056,63848,25208
310M100US24540,24540,2011,90453,60874,29579
310M100US24540,24540,2012,92447,62725,29722
310M200US24540,24540,2013,92426,64555,27871
310M200US24540,24540,2014,96803,68821,27982
310M200US24540,24540,2015,97822,68796,29026
310M300US24540,24540,2016,102087,72083,30004
3100000US24580,24580,2006,119754,85229,34525
3100000US24580,24580,2007,120466,82626,37840
3100000US24580,24580,2008,121495,87204,34291
3100000US24580,24580,2009,122454,85939,36515
310M100US24580,24580,2010,121806,84597,37209
310M100US24580,24580,2011,121930,87515,34415
310M100US24580,24580,2012,122718,83405,39313
310M200US24580,24580,2013,122600,82849,39751
310M200US24580,24580,2014,124899,85113,39786
310M200US24580,24580,2015,127779,87195,40584
310M300US24580,24580,2016,128474,88125,40349
3100000US24620,24620,2006,27584,20550,7034
3100000US24620,24620,2007,27574,19577,7997
3100000US24620,24620,2008,27718,21342,6376
3100000US24620,24620,2009,26977,19484,7493
310M100US24620,24620,2010,28162,20384,7778
310M100US24620,24620,2011,28914,20744,8170
310M100US24620,24620,2012,29562,20721,8841
310M200US24620,24620,2013,27104,20367,6737
310M200US24620,24620,2014,27296,17986,9310
310M200US24620,24620,2015,26660,18935,7725
310M300US24620,24620,2016,25418,19051,6367
310M200US24640,24640,2013,30990,21531,9459
310M200US24640,24640,2014,29859,20614,9245
310M200US24640,24640,2015,30207,20771,9436
310M300US24640,24640,2016,30868,21236,9632
3100000US24660,24660,2006,275011,180865,94146
3100000US24660,24660,2007,279882,184109,95773
3100000US24660,24660,2008,279193,190826,88367
3100000US24660,24660,2009,281813,184390,97423
310M100US24660,24660,2010,282554,183941,98613
310M100US24660,24660,2011,291111,192881,98230
310M100US24660,24660,2012,292421,187703,104718
310M200US24660,24660,2013,289205,178220,110985
310M200US24660,24660,2014,289450,178502,110948
310M200US24660,24660,2015,291088,178510,112578
310M300US24660,24660,2016,296476,181904,114572
3100000US24780,24780,2006,68700,39590,29110
3100000US24780,24780,2007,71098,39067,32031
3100000US24780,24780,2008,70384,41059,29325
3100000US24780,24780,2009,73896,39640,34256
310M100US24780,24780,2010,70345,41149,29196
310M100US24780,24780,2011,70213,38870,31343
310M100US24780,24780,2012,76461,40757,35704
310M200US24780,24780,2013,67573,35693,31880
310M200US24780,24780,2014,68412,34559,33853
310M200US24780,24780,2015,68374,35767,32607
310M300US24780,24780,2016,70019,36950,33069
3100000US24860,24860,2006,232112,157621,74491
3100000US24860,24860,2007,238423,165076,73347
3100000US24860,24860,2008,240808,167475,73333
3100000US24860,24860,2009,241359,164422,76937
310M100US24860,24860,2010,241533,164688,76845
310M100US24860,24860,2011,241622,164425,77197
310M100US24860,24860,2012,245906,161750,84156
310M200US24860,24860,2013,320628,217781,102847
310M200US24860,24860,2014,324282,219220,105062
310M200US24860,24860,2015,332740,222491,110249
310M300US24860,24860,2016,335497,220191,115306
3100000US24940,24940,2006,25045,16756,8289
3100000US24940,24940,2007,25455,18746,6709
3100000US24940,24940,2008,24143,18388,5755
3100000US24940,24940,2009,27040,17914,9126
310M100US24940,24940,2010,26100,17636,8464
310M100US24940,24940,2011,27319,18033,9286
310M100US24940,24940,2012,25342,15816,9526
310M200US24940,24940,2013,37706,25024,12682
310M200US24940,24940,2014,36573,26343,10230
310M200US24940,24940,2015,35010,24748,10262
310M300US24940,24940,2016,36461,23936,12525
3100000US25020,25020,2006,28076,20882,7194
3100000US25020,25020,2007,27280,21384,5896
3100000US25020,25020,2008,24579,19630,4949
3100000US25020,25020,2009,26430,18512,7918
310M100US25020,25020,2010,31192,22875,8317
310M100US25020,25020,2011,28585,19997,8588
310M100US25020,25020,2012,26526,18374,8152
310M200US25020,25020,2013,29865,23532,6333
310M200US25020,25020,2014,28390,21460,6930
310M200US25020,25020,2015,26854,19984,6870
310M300US25020,25020,2016,26740,19619,7121
3100000US25060,25060,2006,86887,60996,25891
3100000US25060,25060,2007,89683,60797,28886
3100000US25060,25060,2008,91817,62731,29086
3100000US25060,25060,2009,89202,60894,28308
310M100US25060,25060,2010,93746,64029,29717
310M100US25060,25060,2011,96451,62413,34038
310M100US25060,25060,2012,100195,61520,38675
310M200US25060,25060,2013,143330,88321,55009
310M200US25060,25060,2014,146693,91780,54913
310M200US25060,25060,2015,146228,90318,55910
310M300US25060,25060,2016,146020,92573,53447
3100000US25180,25180,2006,100404,69089,31315
3100000US25180,25180,2007,100000,70564,29436
3100000US25180,25180,2008,100962,70244,30718
3100000US25180,25180,2009,103027,72229,30798
310M100US25180,25180,2010,101783,70606,31177
310M100US25180,25180,2011,104000,70953,33047
310M100US25180,25180,2012,104765,70344,34421
310M200US25180,25180,2013,97681,64833,32848
310M200US25180,25180,2014,95920,66346,29574
310M200US25180,25180,2015,97209,66773,30436
310M300US25180,25180,2016,98193,69229,28964
3100000US25220,25220,2006,41386,28306,13080
3100000US25220,25220,2007,41369,28364,13005
3100000US25220,25220,2008,45549,29933,15616
3100000US25220,25220,2009,45790,32606,13184
310M100US25220,25220,2010,43228,28350,14878
310M100US25220,25220,2011,44655,31067,13588
310M100US25220,25220,2012,43653,28864,14789
310M200US25220,25220,2013,46039,31583,14456
310M200US25220,25220,2014,45786,30800,14986
310M200US25220,25220,2015,46263,29755,16508
310M300US25220,25220,2016,47756,31181,16575
3100000US25260,25260,2006,39702,22372,17330
3100000US25260,25260,2007,39014,23535,15479
3100000US25260,25260,2008,40495,22409,18086
3100000US25260,25260,2009,38669,19582,19087
310M100US25260,25260,2010,40818,20953,19865
310M100US25260,25260,2011,40800,22822,17978
310M100US25260,25260,2012,40376,19777,20599
310M200US25260,25260,2013,41813,21090,20723
310M200US25260,25260,2014,41596,21384,20212
310M200US25260,25260,2015,42692,20574,22118
310M300US25260,25260,2016,43090,20964,22126
3100000US25420,25420,2006,211096,146120,64976
3100000US25420,25420,2007,213664,150817,62847
3100000US25420,25420,2008,213105,149849,63256
3100000US25420,25420,2009,216137,148443,67694
310M100US25420,25420,2010,221667,155683,65984
310M100US25420,25420,2011,220530,149707,70823
310M100US25420,25420,2012,220146,149372,70774
310M200US25420,25420,2013,224798,151351,73447
310M200US25420,25420,2014,226058,153641,72417
310M200US25420,25420,2015,225810,151994,73816
310M300US25420,25420,2016,225120,152289,72831
3100000US25500,25500,2006,43050,26543,16507
3100000US25500,25500,2007,42628,26532,16096
3100000US25500,25500,2008,43728,28221,15507
3100000US25500,25500,2009,45102,27250,17852
310M100US25500,25500,2010,43840,26360,17480
310M100US25500,25500,2011,44218,28607,15611
310M100US25500,25500,2012,45298,28550,16748
310M200US25500,25500,2013,45285,28587,16698
310M200US25500,25500,2014,47052,27405,19647
310M200US25500,25500,2015,47600,28499,19101
310M300US25500,25500,2016,47805,28436,19369
3100000US25540,25540,2006,456247,315071,141176
3100000US25540,25540,2007,455309,314547,140762
3100000US25540,25540,2008,462687,317748,144939
3100000US25540,25540,2009,457786,318898,138888
310M100US25540,25540,2010,472161,322039,150122
310M100US25540,25540,2011,464933,313252,151681
310M100US25540,25540,2012,468942,312736,156206
310M200US25540,25540,2013,464315,309925,154390
310M200US25540,25540,2014,467615,311614,156001
310M200US25540,25540,2015,464613,308823,155790
310M300US25540,25540,2016,470439,304508,165931
3100000US25620,25620,2006,48827,31229,17598
3100000US25620,25620,2007,49011,32379,16632
3100000US25620,25620,2008,49372,32822,16550
3100000US25620,25620,2009,51036,33323,17713
310M100US25620,25620,2010,53532,34276,19256
310M100US25620,25620,2011,54148,33286,20862
310M100US25620,25620,2012,53480,31352,22128
310M200US25620,25620,2013,53052,30681,22371
310M200US25620,25620,2014,52610,34576,18034
310M200US25620,25620,2015,54780,32663,22117
310M300US25620,25620,2016,53560,32243,21317
3100000US25740,25740,2006,27806,20403,7403
3100000US25740,25740,2007,26906,19887,7019
3100000US25740,25740,2008,27676,20673,7003
3100000US25740,25740,2009,27882,21219,6663
310M100US25740,25740,2010,28653,21682,6971
310M100US25740,25740,2011,32787,23371,9416
310M100US25740,25740,2012,31494,23928,7566
310M200US25740,25740,2013,31069,22676,8393
310M200US25740,25740,2014,31152,21987,9165
310M200US25740,25740,2015,32041,20850,11191
310M300US25740,25740,2016,31474,22066,9408
310M200US25840,25840,2013,31198,18733,12465
310M200US25840,25840,2014,30573,18399,12174
310M200US25840,25840,2015,30427,20285,10142
310M300US25840,25840,2016,29799,20214,9585
3100000US25860,25860,2006,135237,100547,34690
3100000US25860,25860,2007,136721,101076,35645
3100000US25860,25860,2008,136478,98389,38089
3100000US25860,25860,2009,135609,100265,35344
310M100US25860,25860,2010,140327,103017,37310
310M100US25860,25860,2011,135557,97523,38034
310M100US25860,25860,2012,140419,97916,42503
310M200US25860,25860,2013,136858,95428,41430
310M200US25860,25860,2014,131741,91427,40314
310M200US25860,25860,2015,140097,98480,41617
310M300US25860,25860,2016,144399,98232,46167
3100000US25900,25900,2006,63178,41043,22135
3100000US25900,25900,2007,63250,43253,19997
3100000US25900,25900,2008,63088,40587,22501
3100000US25900,25900,2009,65798,41528,24270
310M100US25900,25900,2010,62584,40125,22459
310M100US25900,25900,2011,64605,42462,22143
310M100US25900,25900,2012,64925,42939,21986
310M200US25900,25900,2013,64929,42876,22053
310M200US25900,25900,2014,65178,41681,23497
310M200US25900,25900,2015,64201,43524,20677
310M300US25900,25900,2016,69818,46942,22876
3100000US25940,25940,2006,62705,42795,19910
3100000US25940,25940,2007,66628,46343,20285
3100000US25940,25940,2008,65420,48009,17411
3100000US25940,25940,2009,67735,51319,16416
310M100US25940,25940,2010,72570,49565,23005
310M100US25940,25940,2011,72069,50415,21654
310M100US25940,25940,2012,72852,52139,20713
310M200US25940,25940,2013,74931,52143,22788
310M200US25940,25940,2014,74717,51856,22861
310M200US25940,25940,2015,78824,55263,23561
310M300US25940,25940,2016,76772,56273,20499
3100000US25980,25980,2006,25860,11657,14203
3100000US25980,25980,2007,25371,12859,12512
3100000US25980,25980,2008,25678,12032,13646
3100000US25980,25980,2009,25743,12988,12755
310M100US25980,25980,2010,26902,15966,10936
310M100US25980,25980,2011,29949,16283,13666
310M100US25980,25980,2012,28309,14939,13370
310M200US25980,25980,2013,28505,13618,14887
310M200US25980,25980,2014,28069,13627,14442
310M200US25980,25980,2015,27874,13863,14011
310M300US25980,25980,2016,29918,13446,16472
310M100US26020,26020,2011,20824,14469,6355
310M100US26020,26020,2012,21241,14887,6354
310M200US26020,26020,2013,22418,15302,7116
310M200US26020,26020,2014,21805,15994,5811
310M200US26020,26020,2015,21101,13861,7240
310M300US26020,26020,2016,20793,14003,6790
310M200US26090,26090,2013,41157,33698,7459
310M200US26090,26090,2014,41779,33511,8268
310M200US26090,26090,2015,42079,33215,8864
310M300US26090,26090,2016,41995,35248,6747
3100000US26100,26100,2006,88386,75337,13049
3100000US26100,26100,2007,92845,73481,19364
3100000US26100,26100,2008,93506,76096,17410
3100000US26100,26100,2009,94556,76476,18080
310M100US26100,26100,2010,91334,73091,18243
310M100US26100,26100,2011,94059,71918,22141
310M100US26100,26100,2012,95048,74384,20664
3100000US26140,26140,2006,61256,51176,10080
3100000US26140,26140,2007,58980,48624,10356
3100000US26140,26140,2008,56247,46970,9277
3100000US26140,26140,2009,60522,51389,9133
310M100US26140,26140,2010,60229,49630,10599
310M100US26140,26140,2011,60923,48781,12142
310M100US26140,26140,2012,58640,49398,9242
310M200US26140,26140,2013,62131,49925,12206
310M200US26140,26140,2014,60315,48113,12202
310M200US26140,26140,2015,60541,49292,11249
310M300US26140,26140,2016,63581,51387,12194
3100000US26180,26180,2006,299217,173806,125411
3100000US26180,26180,2007,304611,173715,130896
3100000US26180,26180,2008,302861,176148,126713
3100000US26180,26180,2009,309896,169532,140364
310M100US26180,26180,2010,309154,173487,135667
310M100US26180,26180,2011,308495,168912,139583
310M100US26180,26180,2012,308072,167503,140569
3100000US26300,26300,2006,38005,26739,11266
3100000US26300,26300,2007,38741,25605,13136
3100000US26300,26300,2008,38289,27330,10959
3100000US26300,26300,2009,38203,27687,10516
310M100US26300,26300,2010,38369,26145,12224
310M100US26300,26300,2011,38087,26284,11803
310M100US26300,26300,2012,40656,27734,12922
310M200US26300,26300,2013,41865,27646,14219
310M200US26300,26300,2014,39045,26249,12796
310M200US26300,26300,2015,40134,26398,13736
310M300US26300,26300,2016,39309,26135,13174
3100000US26380,26380,2006,70347,51598,18749
3100000US26380,26380,2007,71988,53380,18608
3100000US26380,26380,2008,72973,55601,17372
3100000US26380,26380,2009,74716,57873,16843
310M100US26380,26380,2010,73829,56014,17815
310M100US26380,26380,2011,75568,54164,21404
310M100US26380,26380,2012,74435,56843,17592
310M200US26380,26380,2013,73418,56910,16508
310M200US26380,26380,2014,74539,51662,22877
310M200US26380,26380,2015,77548,56118,21430
310M300US26380,26380,2016,77301,56113,21188
3100000US26420,26420,2006,1863152,1182763,680389
3100000US26420,26420,2007,1896441,1211389,685052
3100000US26420,26420,2008,1963049,1243989,719060
3100000US26420,26420,2009,2004427,1248025,756402
310M100US26420,26420,2010,2022402,1270817,751585
310M100US26420,26420,2011,2067012,1272526,794486
310M100US26420,26420,2012,2099897,1288302,811595
310M200US26420,26420,2013,2158139,1297710,860429
310M200US26420,26420,2014,2226123,1314711,911412
310M200US26420,26420,2015,2292992,1345294,947698
310M300US26420,26420,2016,2333038,1380359,952679
3100000US26580,26580,2006,115705,83406,32299
3100000US26580,26580,2007,114287,82463,31824
3100000US26580,26580,2008,117570,82414,35156
3100000US26580,26580,2009,118401,81486,36915
310M100US26580,26580,2010,113825,77796,36029
310M100US26580,26580,2011,112805,77265,35540
310M100US26580,26580,2012,112510,80034,32476
310M200US26580,26580,2013,145100,103783,41317
310M200US26580,26580,2014,146108,100929,45179
310M200US26580,26580,2015,140735,99582,41153
310M300US26580,26580,2016,141737,98744,42993
3100000US26620,26620,2006,148226,107259,40967
3100000US26620,26620,2007,148848,106175,42673
3100000US26620,26620,2008,153326,111526,41800
3100000US26620,26620,2009,155251,111074,44177
310M100US26620,26620,2010,160762,116898,43864
310M100US26620,26620,2011,165821,116762,49059
310M100US26620,26620,2012,167556,117395,50161
310M200US26620,26620,2013,169951,115848,54103
310M200US26620,26620,2014,172409,119885,52524
310M200US26620,26620,2015,172549,118894,53655
310M300US26620,26620,2016,175549,120940,54609
310M100US26660,26660,2010,20670,11928,8742
310M100US26660,26660,2011,20400,12418,7982
310M100US26660,26660,2012,20414,11312,9102
310M200US26660,26660,2013,26010,16132,9878
310M200US26660,26660,2014,25219,15659,9560
310M200US26660,26660,2015,27854,16283,11571
310M300US26660,26660,2016,26350,15438,10912
310M100US26740,26740,2010,26095,18892,7203
310M100US26740,26740,2011,25718,17675,8043
310M100US26740,26740,2012,25462,15993,9469
310M200US26740,26740,2013,25048,17036,8012
310M200US26740,26740,2014,24076,16583,7493
310M200US26740,26740,2015,24894,17230,7664
310M300US26740,26740,2016,24934,16621,8313
3100000US26820,26820,2006,40778,30209,10569
3100000US26820,26820,2007,43063,32380,10683
3100000US26820,26820,2008,44086,32337,11749
3100000US26820,26820,2009,42954,32713,10241
310M100US26820,26820,2010,43751,33072,10679
310M100US26820,26820,2011,44680,32638,12042
310M100US26820,26820,2012,43620,33223,10397
310M200US26820,26820,2013,45964,34163,11801
310M200US26820,26820,2014,45712,33888,11824
310M200US26820,26820,2015,45611,32005,13606
310M300US26820,26820,2016,48326,34962,13364
3100000US26860,26860,2006,34260,26190,8070
3100000US26860,26860,2007,35134,24573,10561
3100000US26860,26860,2008,34362,24125,10237
3100000US26860,26860,2009,34485,24163,10322
310M100US26860,26860,2010,34310,25131,9179
310M100US26860,26860,2011,34709,24127,10582
310M100US26860,26860,2012,34934,25715,9219
310M200US26860,26860,2013,33516,24417,9099
310M200US26860,26860,2014,34536,23827,10709
310M200US26860,26860,2015,33066,23539,9527
310M300US26860,26860,2016,34786,24258,10528
3100000US26900,26900,2006,644556,443714,200842
3100000US26900,26900,2007,657445,456731,200714
3100000US26900,26900,2008,666553,462876,203677
3100000US26900,26900,2009,667555,443080,224475
310M100US26900,26900,2010,669860,450234,219626
310M100US26900,26900,2011,674976,446715,228261
310M100US26900,26900,2012,682276,442061,240215
310M200US26900,26900,2013,739503,477758,261745
310M200US26900,26900,2014,744765,481002,263763
310M200US26900,26900,2015,755100,484654,270446
310M300US26900,26900,2016,765240,492348,272892
3100000US26980,26980,2006,58652,36301,22351
3100000US26980,26980,2007,59020,37208,21812
3100000US26980,26980,2008,57692,37107,20585
3100000US26980,26980,2009,60765,38689,22076
310M100US26980,26980,2010,61883,37614,24269
310M100US26980,26980,2011,63209,39060,24149
310M100US26980,26980,2012,64540,39633,24907
310M200US26980,26980,2013,64564,38004,26560
310M200US26980,26980,2014,64409,40715,23694
310M200US26980,26980,2015,64183,38468,25715
310M300US26980,26980,2016,65343,39157,26186
3100000US27060,27060,2006,37861,19073,18788
3100000US27060,27060,2007,37644,20534,17110
3100000US27060,27060,2008,37443,20673,16770
3100000US27060,27060,2009,38291,20213,18078
310M100US27060,27060,2010,37812,21183,16629
310M100US27060,27060,2011,39145,21568,17577
310M100US27060,27060,2012,38269,21196,17073
310M200US27060,27060,2013,37524,21313,16211
310M200US27060,27060,2014,38120,20837,17283
310M200US27060,27060,2015,38112,20540,17572
310M300US27060,27060,2016,37683,20731,16952
3100000US27100,27100,2006,60543,46374,14169
3100000US27100,27100,2007,60965,44960,16005
3100000US27100,27100,2008,58512,45014,13498
3100000US27100,27100,2009,60137,46117,14020
310M100US27100,27100,2010,58388,43722,14666
310M100US27100,27100,2011,58736,41285,17451
310M100US27100,27100,2012,60420,43195,17225
310M200US27100,27100,2013,61235,42598,18637
310M200US27100,27100,2014,61686,46564,15122
310M200US27100,27100,2015,59292,41809,17483
310M300US27100,27100,2016,59993,44077,15916
3100000US27140,27140,2006,192004,132968,59036
3100000US27140,27140,2007,196347,136640,59707
3100000US27140,27140,2008,197846,132379,65467
3100000US27140,27140,2009,195776,127851,67925
310M100US27140,27140,2010,197941,135024,62917
310M100US27140,27140,2011,198067,136113,61954
310M100US27140,27140,2012,196282,130251,66031
310M200US27140,27140,2013,207205,135710,71495
310M200US27140,27140,2014,206952,140960,65992
310M200US27140,27140,2015,210443,141221,69222
310M300US27140,27140,2016,213266,143996,69270
3100000US27180,27180,2006,44736,31177,13559
3100000US27180,27180,2007,45017,29580,15437
3100000US27180,27180,2008,44336,30036,14300
3100000US27180,27180,2009,42764,30954,11810
310M100US27180,27180,2010,39618,25715,13903
310M100US27180,27180,2011,41118,27899,13219
310M100US27180,27180,2012,43040,27839,15201
310M200US27180,27180,2013,47027,30594,16433
310M200US27180,27180,2014,49095,31578,17517
310M200US27180,27180,2015,49318,32863,16455
310M300US27180,27180,2016,48047,30797,17250
3100000US27260,27260,2006,496366,337088,159278
3100000US27260,27260,2007,506456,349454,157002
3100000US27260,27260,2008,501388,341562,159826
3100000US27260,27260,2009,505657,343017,162640
310M100US27260,27260,2010,503541,336462,167079
310M100US27260,27260,2011,508966,343246,165720
310M100US27260,27260,2012,508977,330843,178134
310M200US27260,27260,2013,516144,336866,179278
310M200US27260,27260,2014,528993,328899,200094
310M200US27260,27260,2015,536299,339134,197165
310M300US27260,27260,2016,551172,355926,195246
3100000US27340,27340,2006,53631,31148,22483
3100000US27340,27340,2007,53718,32908,20810
3100000US27340,27340,2008,56617,35246,21371
3100000US27340,27340,2009,59865,32776,27089
310M100US27340,27340,2010,60242,32002,28240
310M100US27340,27340,2011,59806,36369,23437
310M100US27340,27340,2012,61842,33250,28592
310M200US27340,27340,2013,60764,30510,30254
310M200US27340,27340,2014,61873,33853,28020
310M200US27340,27340,2015,64771,33617,31154
310M300US27340,27340,2016,61766,31081,30685
3100000US27460,27460,2006,54003,37632,16371
3100000US27460,27460,2007,54556,36755,17801
3100000US27460,27460,2008,54710,37223,17487
3100000US27460,27460,2009,54668,37285,17383
310M100US27460,27460,2010,55362,39514,15848
310M100US27460,27460,2011,56033,37641,18392
310M100US27460,27460,2012,51814,36199,15615
310M200US27460,27460,2013,54551,37303,17248
310M200US27460,27460,2014,52916,37908,15008
310M200US27460,27460,2015,51579,35903,15676
310M300US27460,27460,2016,51705,35199,16506
3100000US27500,27500,2006,62362,46078,16284
3100000US27500,27500,2007,62566,45847,16719
3100000US27500,27500,2008,62229,45784,16445
3100000US27500,27500,2009,63326,46701,16625
310M100US27500,27500,2010,62555,45491,17064
310M100US27500,27500,2011,63615,44276,19339
310M100US27500,27500,2012,63287,42996,20291
310M200US27500,27500,2013,64088,44707,19381
310M200US27500,27500,2014,63037,42410,20627
310M200US27500,27500,2015,65054,45336,19718
310M300US27500,27500,2016,63222,43739,19483
3100000US27620,27620,2006,53505,38758,14747
3100000US27620,27620,2007,56238,39115,17123
3100000US27620,27620,2008,56202,41784,14418
3100000US27620,27620,2009,54943,41032,13911
310M100US27620,27620,2010,56355,40173,16182
310M100US27620,27620,2011,57184,41428,15756
310M100US27620,27620,2012,57934,41800,16134
310M200US27620,27620,2013,53981,37533,16448
310M200US27620,27620,2014,55887,40533,15354
310M200US27620,27620,2015,55448,38138,17310
310M300US27620,27620,2016,55366,38956,16410
3100000US27740,27740,2006,74998,53919,21079
3100000US27740,27740,2007,77952,51854,26098
3100000US27740,27740,2008,77923,55510,22413
3100000US27740,27740,2009,80350,54910,25440
310M100US27740,27740,2010,82383,58054,24329
310M100US27740,27740,2011,83707,57287,26420
310M100US27740,27740,2012,83530,57903,25627
310M200US27740,27740,2013,83446,56197,27249
310M200US27740,27740,2014,84847,57928,26919
310M200US27740,27740,2015,83074,57915,25159
310M300US27740,27740,2016,83349,53826,29523
3100000US27780,27780,2006,58862,43271,15591
3100000US27780,27780,2007,57721,42543,15178
3100000US27780,27780,2008,59461,43432,16029
3100000US27780,27780,2009,59216,43377,15839
310M100US27780,27780,2010,59030,43177,15853
310M100US27780,27780,2011,57348,42241,15107
310M100US27780,27780,2012,58228,44114,14114
310M200US27780,27780,2013,57407,42903,14504
310M200US27780,27780,2014,57004,41971,15033
310M200US27780,27780,2015,57044,41729,15315
310M300US27780,27780,2016,56443,42272,14171
3100000US27860,27860,2006,43271,28975,14296
3100000US27860,27860,2007,46246,29613,16633
3100000US27860,27860,2008,46964,30568,16396
3100000US27860,27860,2009,46513,26218,20295
310M100US27860,27860,2010,46614,27633,18981
310M100US27860,27860,2011,46977,27645,19332
310M100US27860,27860,2012,47481,28518,18963
310M200US27860,27860,2013,47799,27622,20177
310M200US27860,27860,2014,48043,28838,19205
310M200US27860,27860,2015,48943,28787,20156
310M300US27860,27860,2016,49513,27673,21840
3100000US27900,27900,2006,63853,44333,19520
3100000US27900,27900,2007,63928,43533,20395
3100000US27900,27900,2008,65159,43926,21233
3100000US27900,27900,2009,62321,42931,19390
310M100US27900,27900,2010,66336,46341,19995
310M100US27900,27900,2011,66759,45705,21054
310M100US27900,27900,2012,68745,45269,23476
310M200US27900,27900,2013,67701,45120,22581
310M200US27900,27900,2014,66564,44673,21891
310M200US27900,27900,2015,67439,43986,23453
310M300US27900,27900,2016,67380,44357,23023
3100000US27980,27980,2006,47540,28300,19240
3100000US27980,27980,2007,50568,30749,19819
3100000US27980,27980,2008,48950,28157,20793
3100000US27980,27980,2009,48326,27831,20495
310M100US27980,27980,2010,51893,30809,21084
310M100US27980,27980,2011,52549,29767,22782
310M100US27980,27980,2012,52120,29748,22372
310M200US27980,27980,2013,54005,31904,22101
310M200US27980,27980,2014,54355,30945,23410
310M200US27980,27980,2015,52170,30523,21647
310M300US27980,27980,2016,53667,31726,21941
3100000US28020,28020,2006,125804,88105,37699
3100000US28020,28020,2007,129150,89433,39717
3100000US28020,28020,2008,126738,88451,38287
3100000US28020,28020,2009,129216,86435,42781
310M100US28020,28020,2010,127035,86358,40677
310M100US28020,28020,2011,125379,85965,39414
310M100US28020,28020,2012,128529,86554,41975
310M200US28020,28020,2013,130076,86778,43298
310M200US28020,28020,2014,128755,83285,45470
310M200US28020,28020,2015,129792,87079,42713
310M300US28020,28020,2016,131673,88861,42812
3100000US28060,28060,2006,31409,23897,7512
3100000US28060,28060,2007,31083,21859,9224
3100000US28060,28060,2008,31125,23069,8056
3100000US28060,28060,2009,30997,23308,7689
310M100US28060,28060,2010,36709,24412,12297
310M100US28060,28060,2011,37597,26902,10695
310M100US28060,28060,2012,37405,26006,11399
310M200US28060,28060,2013,36391,25583,10808
310M200US28060,28060,2014,36820,25631,11189
310M200US28060,28060,2015,37307,26012,11295
310M300US28060,28060,2016,39279,28831,10448
3100000US28100,28100,2006,40240,27843,12397
3100000US28100,28100,2007,40522,28995,11527
3100000US28100,28100,2008,39938,27507,12431
3100000US28100,28100,2009,39005,26888,12117
310M100US28100,28100,2010,42046,28191,13855
310M100US28100,28100,2011,41149,29074,12075
310M100US28100,28100,2012,41267,28587,12680
310M200US28100,28100,2013,41822,28225,13597
310M200US28100,28100,2014,40732,28105,12627
310M200US28100,28100,2015,38755,26331,12424
310M300US28100,28100,2016,39314,26879,12435
3100000US28140,28140,2006,770828,537213,233615
3100000US28140,28140,2007,771959,534418,237541
3100000US28140,28140,2008,785377,541673,243704
3100000US28140,28140,2009,789734,536634,253100
310M100US28140,28140,2010,785477,532882,252595
310M100US28140,28140,2011,794197,534278,259919
310M100US28140,28140,2012,801060,527391,273669
310M200US28140,28140,2013,798618,514952,283666
310M200US28140,28140,2014,800035,517122,282913
310M200US28140,28140,2015,814092,531255,282837
310M300US28140,28140,2016,816569,526453,290116
310M100US28180,28180,2010,22147,14112,8035
310M100US28180,28180,2011,22874,13559,9315
310M100US28180,28180,2012,22569,14580,7989
310M200US28180,28180,2013,22386,13802,8584
310M200US28180,28180,2014,22234,14541,7693
310M200US28180,28180,2015,21862,13618,8244
310M300US28180,28180,2016,23214,14616,8598
3100000US28300,28300,2006,29948,20630,9318
3100000US28300,28300,2007,29539,21310,8229
3100000US28300,28300,2008,28785,20364,8421
3100000US28300,28300,2009,29573,21771,7802
310M100US28300,28300,2010,29931,20222,9709
310M100US28300,28300,2011,30565,21177,9388
310M100US28300,28300,2012,30301,22061,8240
310M200US28300,28300,2013,30603,21911,8692
310M200US28300,28300,2014,31305,21615,9690
310M200US28300,28300,2015,29657,21042,8615
310M300US28300,28300,2016,29428,19550,9878
3100000US28420,28420,2006,76948,52786,24162
3100000US28420,28420,2007,76441,53208,23233
3100000US28420,28420,2008,81014,57251,23763
3100000US28420,28420,2009,82323,55904,26419
310M100US28420,28420,2010,86626,58534,28092
310M100US28420,28420,2011,88930,60420,28510
310M100US28420,28420,2012,90215,61315,28900
310M200US28420,28420,2013,92768,63125,29643
310M200US28420,28420,2014,93357,61963,31394
310M200US28420,28420,2015,94423,63632,30791
310M300US28420,28420,2016,96337,66899,29438
3100000US28580,28580,2006,33013,21885,11128
3100000US28580,28580,2007,29109,19692,9417
3100000US28580,28580,2008,29084,20132,8952
3100000US28580,28580,2009,28335,17901,10434
310M100US28580,28580,2010,29822,17523,12299
310M100US28580,28580,2011,24735,14878,9857
310M100US28580,28580,2012,29241,17696,11545
310M200US28580,28580,2013,26426,16285,10141
310M200US28580,28580,2014,28065,16270,11795
310M200US28580,28580,2015,31391,19025,12366
310M300US28580,28580,2016,30318,17449,12869
3100000US28660,28660,2006,122444,73269,49175
3100000US28660,28660,2007,122359,78233,44126
3100000US28660,28660,2008,128041,76266,51775
3100000US28660,28660,2009,124651,71905,52746
310M100US28660,28660,2010,131062,75880,55182
310M100US28660,28660,2011,128008,71620,56388
310M100US28660,28660,2012,133995,77619,56376
310M200US28660,28660,2013,132578,76218,56360
310M200US28660,28660,2014,145055,79143,65912
310M200US28660,28660,2015,151623,80188,71435
310M300US28660,28660,2016,150422,83717,66705
3100000US28700,28700,2006,127461,96484,30977
3100000US28700,28700,2007,129966,96003,33963
3100000US28700,28700,2008,129705,96447,33258
3100000US28700,28700,2009,130619,94506,36113
310M100US28700,28700,2010,130117,94354,35763
310M100US28700,28700,2011,130599,95844,34755
310M100US28700,28700,2012,127704,94170,33534
310M200US28700,28700,2013,126215,94178,32037
310M200US28700,28700,2014,130044,95698,34346
310M200US28700,28700,2015,126840,89748,37092
310M300US28700,28700,2016,123757,88696,35061
3100000US28740,28740,2006,70693,47444,23249
3100000US28740,28740,2007,69259,48267,20992
3100000US28740,28740,2008,70048,45968,24080
3100000US28740,28740,2009,70971,49853,21118
310M100US28740,28740,2010,68581,47567,21014
310M100US28740,28740,2011,69127,45415,23712
310M100US28740,28740,2012,70353,48938,21415
310M200US28740,28740,2013,68650,48419,20231
310M200US28740,28740,2014,69522,47857,21665
310M200US28740,28740,2015,69594,47653,21941
310M300US28740,28740,2016,68298,46444,21854
3100000US28900,28900,2006,26950,18139,8811
3100000US28900,28900,2007,26921,19661,7260
3100000US28900,28900,2008,26758,17975,8783
3100000US28900,28900,2009,27787,18247,9540
310M100US28900,28900,2010,27582,18856,8726
310M100US28900,28900,2011,26507,17898,8609
310M100US28900,28900,2012,29287,17994,11293
310M200US28900,28900,2013,25746,16874,8872
310M200US28900,28900,2014,26377,16614,9763
310M200US28900,28900,2015,27144,17153,9991
310M300US28900,28900,2016,26359,16934,9425
3100000US28940,28940,2006,274568,192022,82546
3100000US28940,28940,2007,282643,200239,82404
3100000US28940,28940,2008,284784,199018,85766
3100000US28940,28940,2009,286181,200988,85193
310M100US28940,28940,2010,285762,197407,88355
310M100US28940,28940,2011,288165,194893,93272
310M100US28940,28940,2012,290393,194904,95489
310M200US28940,28940,2013,340089,228478,111611
310M200US28940,28940,2014,336174,234496,101678
310M200US28940,28940,2015,343331,232646,110685
310M300US28940,28940,2016,344803,234497,110306
3100000US29020,29020,2006,41437,29113,12324
3100000US29020,29020,2007,42155,30392,11763
3100000US29020,29020,2008,40091,27888,12203
3100000US29020,29020,2009,40696,29768,10928
310M100US29020,29020,2010,40775,28661,12114
310M100US29020,29020,2011,41094,28905,12189
310M100US29020,29020,2012,40571,28942,11629
310M200US29020,29020,2013,34435,23473,10962
310M200US29020,29020,2014,34026,22254,11772
310M200US29020,29020,2015,34714,23738,10976
310M300US29020,29020,2016,34195,22709,11486
3100000US29100,29100,2006,51823,36580,15243
3100000US29100,29100,2007,52709,35772,16937
3100000US29100,29100,2008,53911,37851,16060
3100000US29100,29100,2009,52806,36069,16737
310M100US29100,29100,2010,53627,35564,18063
310M100US29100,29100,2011,53426,36632,16794
310M100US29100,29100,2012,54799,36351,18448
310M200US29100,29100,2013,53723,35682,18041
310M200US29100,29100,2014,54762,36833,17929
310M200US29100,29100,2015,54008,36096,17912
310M300US29100,29100,2016,55390,37025,18365
3100000US29140,29140,2006,71598,43041,28557
3100000US29140,29140,2007,73019,42817,30202
3100000US29140,29140,2008,72547,43544,29003
3100000US29140,29140,2009,74429,42320,32109
310M100US29140,29140,2010,76945,46413,30532
310M100US29140,29140,2011,78249,43368,34881
310M100US29140,29140,2012,79034,46292,32742
3100000US29180,29180,2006,101104,68793,32311
3100000US29180,29180,2007,101991,67448,34543
3100000US29180,29180,2008,100710,68754,31956
3100000US29180,29180,2009,100730,70321,30409
310M100US29180,29180,2010,103181,68707,34474
310M100US29180,29180,2011,105130,70516,34614
310M100US29180,29180,2012,106842,71166,35676
310M200US29180,29180,2013,178778,127050,51728
310M200US29180,29180,2014,178319,118600,59719
310M200US29180,29180,2015,180902,123813,57089
310M300US29180,29180,2016,177425,124375,53050
310M200US29200,29200,2013,79375,44264,35111
310M200US29200,29200,2014,77266,44244,33022
310M200US29200,29200,2015,81069,45589,35480
310M300US29200,29200,2016,80560,47849,32711
310M100US29300,29300,2010,24697,16071,8626
310M100US29300,29300,2011,24744,14987,9757
310M100US29300,29300,2012,24539,15282,9257
310M200US29300,29300,2013,24412,13482,10930
310M200US29300,29300,2014,23942,13576,10366
310M200US29300,29300,2015,25092,13305,11787
310M300US29300,29300,2016,24493,14617,9876
3100000US29340,29340,2006,73337,51201,22136
3100000US29340,29340,2007,75750,52376,23374
3100000US29340,29340,2008,75081,54379,20702
3100000US29340,29340,2009,74256,52909,21347
310M100US29340,29340,2010,75197,56026,19171
310M100US29340,29340,2011,75308,51826,23482
310M100US29340,29340,2012,77201,54877,22324
310M200US29340,29340,2013,79392,54211,25181
310M200US29340,29340,2014,76395,51286,25109
310M200US29340,29340,2015,79853,54891,24962
310M300US29340,29340,2016,79226,51497,27729
3100000US29380,29380,2006,24244,16574,7670
3100000US29380,29380,2007,24093,15940,8153
3100000US29380,29380,2008,25467,18046,7421
3100000US29380,29380,2009,23230,16091,7139
310M100US29380,29380,2010,25705,18546,7159
310M100US29380,29380,2011,23883,15097,8786
310M100US29380,29380,2012,22636,16497,6139
310M200US29380,29380,2013,23827,17571,6256
310M200US29380,29380,2014,23825,17818,6007
310M200US29380,29380,2015,24238,16564,7674
310M300US29380,29380,2016,24215,16904,7311
3100000US29420,29420,2006,76249,51475,24774
3100000US29420,29420,2007,73479,51539,21940
3100000US29420,29420,2008,73884,50386,23498
3100000US29420,29420,2009,73864,53255,20609
310M100US29420,29420,2010,82166,58114,24052
310M100US29420,29420,2011,78977,54629,24348
310M100US29420,29420,2012,79239,50942,28297
310M200US29420,29420,2013,81257,54283,26974
310M200US29420,29420,2014,81292,54634,26658
310M200US29420,29420,2015,83801,56287,27514
310M300US29420,29420,2016,84876,58167,26709
3100000US29460,29460,2006,224818,158767,66051
3100000US29460,29460,2007,225873,163255,62618
3100000US29460,29460,2008,223931,156012,67919
3100000US29460,29460,2009,222239,158662,63577
310M100US29460,29460,2010,221073,157205,63868
310M100US29460,29460,2011,217648,151549,66099
310M100US29460,29460,2012,223507,151595,71912
310M200US29460,29460,2013,214500,147213,67287
310M200US29460,29460,2014,218286,149614,68672
310M200US29460,29460,2015,227122,152419,74703
310M300US29460,29460,2016,226429,153753,72676
3100000US29540,29540,2006,184581,130513,54068
3100000US29540,29540,2007,186136,131491,54645
3100000US29540,29540,2008,186441,131622,54819
3100000US29540,29540,2009,188574,131546,57028
310M100US29540,29540,2010,194028,134960,59068
310M100US29540,29540,2011,193231,135268,57963
310M100US29540,29540,2012,194198,134085,60113
310M200US29540,29540,2013,194493,133396,61097
310M200US29540,29540,2014,194764,131998,62766
310M200US29540,29540,2015,197706,133227,64479
310M300US29540,29540,2016,196807,133078,63729
3100000US29580,29580,2007,26880,20198,6682
3100000US29580,29580,2008,26279,19053,7226
3100000US29580,29580,2009,25845,18550,7295
310M100US29580,29580,2010,29862,21289,8573
310M100US29580,29580,2011,29930,21925,8005
310M100US29580,29580,2012,28792,22580,6212
3100000US29620,29620,2006,178261,123627,54634
3100000US29620,29620,2007,178057,123356,54701
3100000US29620,29620,2008,177726,124224,53502
3100000US29620,29620,2009,177415,119405,58010
310M100US29620,29620,2010,178797,119213,59584
310M100US29620,29620,2011,179538,116470,63068
310M100US29620,29620,2012,181262,118078,63184
310M200US29620,29620,2013,183135,115512,67623
310M200US29620,29620,2014,183357,117593,65764
310M200US29620,29620,2015,183888,118081,65807
310M300US29620,29620,2016,185389,119474,65915
3100000US29700,29700,2006,60385,39371,21014
3100000US29700,29700,2007,62424,40619,21805
3100000US29700,29700,2008,65111,42280,22831
3100000US29700,29700,2009,65178,42671,22507
310M100US29700,29700,2010,66716,39900,26816
310M100US29700,29700,2011,67463,41714,25749
310M100US29700,29700,2012,68980,43670,25310
310M200US29700,29700,2013,68696,45093,23603
310M200US29700,29700,2014,70418,43107,27311
310M200US29700,29700,2015,72259,44726,27533
310M300US29700,29700,2016,73483,46629,26854
3100000US29740,29740,2006,67125,42887,24238
3100000US29740,29740,2007,69836,45966,23870
3100000US29740,29740,2008,69848,46593,23255
3100000US29740,29740,2009,71243,46681,24562
310M100US29740,29740,2010,73614,46330,27284
310M100US29740,29740,2011,75078,49992,25086
310M100US29740,29740,2012,73717,48083,25634
310M200US29740,29740,2013,74898,48140,26758
310M200US29740,29740,2014,75530,46230,29300
310M200US29740,29740,2015,74631,46925,27706
310M300US29740,29740,2016,75759,45277,30482
3100000US29820,29820,2006,665509,402947,262562
3100000US29820,29820,2007,683034,400363,282671
3100000US29820,29820,2008,684605,398409,286196
3100000US29820,29820,2009,694144,394845,299299
310M100US29820,29820,2010,698955,384368,314587
310M100US29820,29820,2011,696834,373500,323334
310M100US29820,29820,2012,715837,376102,339735
310M200US29820,29820,2013,713577,370394,343183
310M200US29820,29820,2014,731322,367897,363425
310M200US29820,29820,2015,740966,382183,358783
310M300US29820,29820,2016,755258,395147,360111
3100000US29860,29860,2006,32797,24741,8056
3100000US29860,29860,2007,32268,23657,8611
3100000US29860,29860,2008,32551,24538,8013
3100000US29860,29860,2009,32827,24246,8581
310M100US29860,29860,2010,31467,24116,7351
310M100US29860,29860,2011,31987,24420,7567
310M100US29860,29860,2012,31722,23918,7804
310M200US29860,29860,2013,30768,23529,7239
310M200US29860,29860,2014,31075,22710,8365
310M200US29860,29860,2015,31527,23845,7682
310M300US29860,29860,2016,31111,22881,8230
3100000US29940,29940,2006,42662,25708,16954
3100000US29940,29940,2007,43967,25200,18767
3100000US29940,29940,2008,43730,23507,20223
3100000US29940,29940,2009,44042,23475,20567
310M100US29940,29940,2010,43385,20918,22467
310M100US29940,29940,2011,43371,22359,21012
310M100US29940,29940,2012,43992,22422,21570
310M200US29940,29940,2013,42470,22698,19772
310M200US29940,29940,2014,45224,23795,21429
310M200US29940,29940,2015,42817,23044,19773
310M300US29940,29940,2016,45572,22872,22700
3100000US30020,30020,2006,41630,24962,16668
3100000US30020,30020,2007,41137,25425,15712
3100000US30020,30020,2008,42056,25537,16519
3100000US30020,30020,2009,41347,24532,16815
310M100US30020,30020,2010,46141,25875,20266
310M100US30020,30020,2011,44879,25429,19450
310M100US30020,30020,2012,43470,25286,18184
310M200US30020,30020,2013,45871,24436,21435
310M200US30020,30020,2014,43648,24715,18933
310M200US30020,30020,2015,43678,23381,20297
310M300US30020,30020,2016,45111,23821,21290
3100000US30100,30100,2006,68985,50760,18225
3100000US30100,30100,2007,69351,51425,17926
3100000US30100,30100,2008,67776,49425,18351
3100000US30100,30100,2009,68685,50726,17959
310M100US30100,30100,2010,70768,51177,19591
310M100US30100,30100,2011,70712,49817,20895
310M100US30100,30100,2012,73012,51869,21143
3100000US30140,30140,2006,49379,37826,11553
3100000US30140,30140,2007,50110,37341,12769
3100000US30140,30140,2008,51385,38167,13218
3100000US30140,30140,2009,51614,37853,13761
310M100US30140,30140,2010,50701,36451,14250
310M100US30140,30140,2011,51744,38116,13628
310M100US30140,30140,2012,52424,36872,15552
310M200US30140,30140,2013,51901,35813,16088
310M200US30140,30140,2014,51234,35555,15679
310M200US30140,30140,2015,53200,36071,17129
310M300US30140,30140,2016,51143,35574,15569
3100000US30300,30300,2009,23660,15458,8202
310M100US30300,30300,2010,25143,18108,7035
310M100US30300,30300,2011,24682,17414,7268
310M100US30300,30300,2012,25325,15674,9651
310M200US30300,30300,2013,24527,18128,6399
310M200US30300,30300,2014,25932,17136,8796
310M200US30300,30300,2015,25354,17949,7405
310M300US30300,30300,2016,26373,17840,8533
3100000US30340,30340,2006,43684,28699,14985
3100000US30340,30340,2007,44369,29781,14588
3100000US30340,30340,2008,43334,29123,14211
3100000US30340,30340,2009,42718,27946,14772
310M100US30340,30340,2010,43918,29270,14648
310M100US30340,30340,2011,44655,28084,16571
310M100US30340,30340,2012,44641,28777,15864
310M200US30340,30340,2013,43736,24980,18756
310M200US30340,30340,2014,44267,28990,15277
310M200US30340,30340,2015,45138,28423,16715
310M300US30340,30340,2016,44917,28224,16693
3100000US30460,30460,2006,181715,111534,70181
3100000US30460,30460,2007,183856,115181,68675
3100000US30460,30460,2008,188673,116800,71873
3100000US30460,30460,2009,188888,111686,77202
310M100US30460,30460,2010,190535,111090,79445
310M100US30460,30460,2011,189941,117541,72400
310M100US30460,30460,2012,191487,113207,78280
310M200US30460,30460,2013,193193,110887,82306
310M200US30460,30460,2014,196716,113445,83271
310M200US30460,30460,2015,199299,111922,87377
310M300US30460,30460,2016,197789,116937,80852
3100000US30500,30500,2006,36354,26149,10205
3100000US30500,30500,2007,36841,26763,10078
3100000US30500,30500,2008,36933,26629,10304
3100000US30500,30500,2009,37546,27354,10192
310M100US30500,30500,2010,37051,26740,10311
310M100US30500,30500,2011,36967,27038,9929
310M100US30500,30500,2012,39195,27462,11733
3100000US30620,30620,2006,40033,30051,9982
3100000US30620,30620,2007,41743,29677,12066
3100000US30620,30620,2008,39989,27846,12143
3100000US30620,30620,2009,41294,29071,12223
310M100US30620,30620,2010,40615,27890,12725
310M100US30620,30620,2011,40269,28280,11989
310M100US30620,30620,2012,40366,27564,12802
310M200US30620,30620,2013,40359,26063,14296
310M200US30620,30620,2014,39412,26130,13282
310M200US30620,30620,2015,40234,26531,13703
310M300US30620,30620,2016,39982,26298,13684
3100000US30700,30700,2006,114385,72133,42252
3100000US30700,30700,2007,114859,73079,41780
3100000US30700,30700,2008,114128,74266,39862
3100000US30700,30700,2009,117452,71848,45604
310M100US30700,30700,2010,120407,72795,47612
310M100US30700,30700,2011,120966,73457,47509
310M100US30700,30700,2012,121906,72025,49881
310M200US30700,30700,2013,123469,75720,47749
310M200US30700,30700,2014,125923,76442,49481
310M200US30700,30700,2015,127316,75422,51894
310M300US30700,30700,2016,128292,76387,51905
3100000US30740,30740,2006,27271,20845,6426
3100000US30740,30740,2007,28117,21797,6320
3100000US30740,30740,2008,28017,20108,7909
3100000US30740,30740,2009,28854,21056,7798
310M100US30740,30740,2010,29404,23325,6079
310M100US30740,30740,2011,28730,22392,6338
310M100US30740,30740,2012,31298,23729,7569
3100000US30780,30780,2006,264312,175653,88659
3100000US30780,30780,2007,260616,177273,83343
3100000US30780,30780,2008,272612,177251,95361
3100000US30780,30780,2009,269175,172005,97170
310M100US30780,30780,2010,272455,178098,94357
310M100US30780,30780,2011,273692,179556,94136
310M100US30780,30780,2012,277026,181040,95986
310M200US30780,30780,2013,267748,176382,91366
310M200US30780,30780,2014,273841,172816,101025
310M200US30780,30780,2015,282914,178436,104478
310M300US30780,30780,2016,285036,178459,106577
3100000US30860,30860,2006,35487,23496,11991
3100000US30860,30860,2007,35980,25082,10898
3100000US30860,30860,2008,37745,25035,12710
3100000US30860,30860,2009,37786,24250,13536
310M100US30860,30860,2010,40170,26239,13931
310M100US30860,30860,2011,38677,25780,12897
310M100US30860,30860,2012,39798,27196,12602
310M200US30860,30860,2013,39593,26865,12728
310M200US30860,30860,2014,40017,26206,13811
310M200US30860,30860,2015,40927,26789,14138
310M300US30860,30860,2016,41158,25881,15277
310M200US30940,30940,2013,47946,31580,16366
310M200US30940,30940,2014,47472,31807,15665
310M200US30940,30940,2015,48946,33725,15221
310M300US30940,30940,2016,44859,32214,12645
3100000US30980,30980,2006,76801,54310,22491
3100000US30980,30980,2007,78074,52415,25659
3100000US30980,30980,2008,79198,53150,26048
3100000US30980,30980,2009,77214,52479,24735
310M100US30980,30980,2010,76660,53731,22929
310M100US30980,30980,2011,76849,52853,23996
310M100US30980,30980,2012,75316,52124,23192
310M200US30980,30980,2013,76957,49648,27309
310M200US30980,30980,2014,78567,53478,25089
310M200US30980,30980,2015,76401,50446,25955
310M300US30980,30980,2016,77356,50756,26600
3100000US31020,31020,2006,37963,26780,11183
3100000US31020,31020,2007,38117,25188,12929
3100000US31020,31020,2008,38042,25916,12126
3100000US31020,31020,2009,38507,25746,12761
310M100US31020,31020,2010,40475,25089,15386
310M100US31020,31020,2011,40659,26863,13796
310M100US31020,31020,2012,38834,24830,14004
310M200US31020,31020,2013,38483,25983,12500
310M200US31020,31020,2014,40036,25341,14695
310M200US31020,31020,2015,40187,26585,13602
310M300US31020,31020,2016,40170,27344,12826
310M200US31080,31080,2013,4251495,2055136,2196359
310M200US31080,31080,2014,4287974,2071774,2216200
310M200US31080,31080,2015,4315637,2065358,2250279
310M300US31080,31080,2016,4337807,2058153,2279654
3100000US31100,31100,2006,4143240,2170255,1972985
3100000US31100,31100,2007,4158616,2170961,1987655
3100000US31100,31100,2008,4139921,2121508,2018413
3100000US31100,31100,2009,4142093,2101299,2040794
310M100US31100,31100,2010,4188650,2085762,2102888
310M100US31100,31100,2011,4194650,2064002,2130648
310M100US31100,31100,2012,4227028,2047078,2179950
3100000US31140,31140,2006,489229,345142,144087
3100000US31140,31140,2007,490447,344798,145649
3100000US31140,31140,2008,497535,349795,147740
3100000US31140,31140,2009,500367,343016,157351
310M100US31140,31140,2010,510653,348887,161766
310M100US31140,31140,2011,499056,342917,156139
310M100US31140,31140,2012,510269,342816,167453
310M200US31140,31140,2013,494276,334631,159645
310M200US31140,31140,2014,493973,327497,166476
310M200US31140,31140,2015,496455,329512,166943
310M300US31140,31140,2016,501827,330186,171641
3100000US31180,31180,2006,103957,61265,42692
3100000US31180,31180,2007,102662,62182,40480
3100000US31180,31180,2008,107411,67166,40245
3100000US31180,31180,2009,107782,62568,45214
310M100US31180,31180,2010,107367,62252,45115
310M100US31180,31180,2011,106702,61774,44928
310M100US31180,31180,2012,108426,61804,46622
310M200US31180,31180,2013,110295,64825,45470
310M200US31180,31180,2014,115322,64936,50386
310M200US31180,31180,2015,112853,61645,51208
310M300US31180,31180,2016,116122,65246,50876
3100000US31260,31260,2006,30679,20937,9742
3100000US31260,31260,2007,29877,20501,9376
3100000US31260,31260,2008,30236,20172,10064
3100000US31260,31260,2009,29418,20636,8782
310M100US31260,31260,2010,31735,20754,10981
310M100US31260,31260,2011,30706,20341,10365
310M100US31260,31260,2012,30199,19593,10606
310M200US31260,31260,2013,30103,19079,11024
310M200US31260,31260,2014,30344,21153,9191
310M200US31260,31260,2015,30052,18380,11672
310M300US31260,31260,2016,30210,18654,11556
3100000US31300,31300,2006,42811,28135,14676
3100000US31300,31300,2007,43263,29784,13479
3100000US31300,31300,2008,41909,28986,12923
3100000US31300,31300,2009,43393,29825,13568
310M100US31300,31300,2010,43237,28007,15230
310M100US31300,31300,2011,44026,28481,15545
310M100US31300,31300,2012,46555,29510,17045
310M200US31300,31300,2013,45641,28660,16981
310M200US31300,31300,2014,46484,29815,16669
310M200US31300,31300,2015,45373,27481,17892
310M300US31300,31300,2016,45123,30327,14796
3100000US31340,31340,2006,97175,72259,24916
3100000US31340,31340,2007,96430,68913,27517
3100000US31340,31340,2008,97770,70857,26913
3100000US31340,31340,2009,96823,70804,26019
310M100US31340,31340,2010,96553,68357,28196
310M100US31340,31340,2011,97771,70833,26938
310M100US31340,31340,2012,99273,71360,27913
310M200US31340,31340,2013,102320,71871,30449
310M200US31340,31340,2014,98399,69581,28818
310M200US31340,31340,2015,100497,68600,31897
310M300US31340,31340,2016,97679,69195,28484
3100000US31420,31420,2006,82317,53565,28752
3100000US31420,31420,2007,85104,57432,27672
3100000US31420,31420,2008,88284,57495,30789
3100000US31420,31420,2009,86053,54575,31478
310M100US31420,31420,2010,82543,52510,30033
310M100US31420,31420,2011,83811,51406,32405
310M100US31420,31420,2012,84022,51563,32459
310M200US31420,31420,2013,80190,47802,32388
310M200US31420,31420,2014,84688,51356,33332
310M200US31420,31420,2015,86400,53573,32827
310M300US31420,31420,2016,86633,50672,35961
3100000US31460,31460,2006,41052,25064,15988
3100000US31460,31460,2007,43355,27034,16321
3100000US31460,31460,2008,41888,24974,16914
3100000US31460,31460,2009,43393,27746,15647
310M100US31460,31460,2010,42189,25469,16720
310M100US31460,31460,2011,40786,24738,16048
310M100US31460,31460,2012,41035,24555,16480
310M200US31460,31460,2013,44549,25570,18979
310M200US31460,31460,2014,42895,26312,16583
310M200US31460,31460,2015,45224,27947,17277
310M300US31460,31460,2016,44369,26536,17833
3100000US31540,31540,2006,218143,143215,74928
3100000US31540,31540,2007,218478,147475,71003
3100000US31540,31540,2008,226131,146062,80069
3100000US31540,31540,2009,237649,148019,89630
310M100US31540,31540,2010,235533,148039,87494
310M100US31540,31540,2011,237667,145279,92388
310M100US31540,31540,2012,239964,146495,93469
310M200US31540,31540,2013,258127,156333,101794
310M200US31540,31540,2014,259371,155737,103634
310M200US31540,31540,2015,264340,160229,104111
310M300US31540,31540,2016,265172,165573,99599
3100000US31700,31700,2006,149862,105010,44852
3100000US31700,31700,2007,152397,107166,45231
3100000US31700,31700,2008,149731,103351,46380
3100000US31700,31700,2009,151520,103669,47851
310M100US31700,31700,2010,152652,103983,48669
310M100US31700,31700,2011,153186,102156,51030
310M100US31700,31700,2012,155260,104741,50519
310M200US31700,31700,2013,155036,101661,53375
310M200US31700,31700,2014,153482,101842,51640
310M200US31700,31700,2015,156678,104150,52528
310M300US31700,31700,2016,158777,100789,57988
3100000US31740,31740,2006,40137,22460,17677
3100000US31740,31740,2007,43873,24553,19320
3100000US31740,31740,2008,43330,23456,19874
3100000US31740,31740,2009,42605,20760,21845
310M100US31740,31740,2010,45851,22796,23055
310M100US31740,31740,2011,45505,22222,23283
310M100US31740,31740,2012,47675,23563,24112
310M200US31740,31740,2013,35044,18069,16975
310M200US31740,31740,2014,34452,17340,17112
310M200US31740,31740,2015,34806,17555,17251
310M300US31740,31740,2016,34357,17283,17074
3100000US31820,31820,2006,33210,26202,7008
3100000US31820,31820,2007,33385,25425,7960
3100000US31820,31820,2008,33571,24592,8979
3100000US31820,31820,2009,34811,27315,7496
310M100US31820,31820,2010,34575,26594,7981
310M100US31820,31820,2011,34029,26739,7290
310M100US31820,31820,2012,33926,25046,8880
310M200US31820,31820,2013,33343,25358,7985
310M200US31820,31820,2014,33272,25004,8268
310M200US31820,31820,2015,34508,25909,8599
310M300US31820,31820,2016,34234,25968,8266
3100000US31860,31860,2006,35321,24660,10661
3100000US31860,31860,2007,35564,26179,9385
3100000US31860,31860,2008,36165,24976,11189
3100000US31860,31860,2009,35200,24933,10267
310M100US31860,31860,2010,36886,25027,11859
310M100US31860,31860,2011,36759,25288,11471
310M100US31860,31860,2012,36476,25341,11135
310M200US31860,31860,2013,37358,25293,12065
310M200US31860,31860,2014,37736,24654,13082
310M200US31860,31860,2015,38444,25611,12833
310M300US31860,31860,2016,37898,24193,13705
3100000US31900,31900,2006,49153,35635,13518
3100000US31900,31900,2007,48884,35603,13281
3100000US31900,31900,2008,47940,33816,14124
3100000US31900,31900,2009,49672,34881,14791
310M100US31900,31900,2010,47654,33151,14503
310M100US31900,31900,2011,48616,33363,15253
310M100US31900,31900,2012,48529,34207,14322
310M200US31900,31900,2013,47847,31894,15953
310M200US31900,31900,2014,47378,32575,14803
310M200US31900,31900,2015,46989,31925,15064
310M300US31900,31900,2016,48437,32388,16049
3100000US31940,31940,2006,29231,22768,6463
3100000US31940,31940,2007,29651,23229,6422
3100000US31940,31940,2008,30474,23952,6522
3100000US31940,31940,2009,31540,23789,7751
310M100US31940,31940,2010,29731,24121,5610
310M100US31940,31940,2011,28276,22063,6213
310M100US31940,31940,2012,28638,22439,6199
310M200US31940,31940,2013,28695,22254,6441
310M200US31940,31940,2014,30183,23580,6603
310M200US31940,31940,2015,28949,21404,7545
310M300US31940,31940,2016,28955,22104,6851
3100000US31980,31980,2006,26555,18920,7635
3100000US31980,31980,2007,27758,20122,7636
3100000US31980,31980,2008,27466,18653,8813
3100000US31980,31980,2009,27243,18839,8404
310M100US31980,31980,2010,26767,19260,7507
310M100US31980,31980,2011,27758,18997,8761
310M100US31980,31980,2012,26803,19601,7202
310M200US31980,31980,2013,27003,17673,9330
310M200US31980,31980,2014,25600,17954,7646
310M200US31980,31980,2015,25137,16577,8560
310M300US31980,31980,2016,26528,16431,10097
3100000US32020,32020,2006,25193,19315,5878
3100000US32020,32020,2007,25043,16733,8310
3100000US32020,32020,2008,24579,16725,7854
3100000US32020,32020,2009,24527,17857,6670
310M100US32020,32020,2010,25438,17182,8256
310M100US32020,32020,2011,24654,15685,8969
310M100US32020,32020,2012,24496,16236,8260
310M200US32020,32020,2013,24084,17516,6568
310M200US32020,32020,2014,24346,16422,7924
310M200US32020,32020,2015,24364,15160,9204
310M300US32020,32020,2016,25114,16546,8568
3100000US32060,32060,2009,26982,19452,7530
310M100US32060,32060,2010,25953,19346,6607
310M100US32060,32060,2011,26648,19022,7626
310M100US32060,32060,2012,26863,18989,7874
3100000US32100,32100,2007,24940,18240,6700
3100000US32100,32100,2008,24421,18592,5829
3100000US32100,32100,2009,25447,16986,8461
310M100US32100,32100,2010,27094,19955,7139
310M100US32100,32100,2011,26582,17646,8936
310M100US32100,32100,2012,27203,19033,8170
310M200US32100,32100,2013,25676,18304,7372
310M200US32100,32100,2014,26250,17539,8711
310M200US32100,32100,2015,25498,17644,7854
310M300US32100,32100,2016,25822,18986,6836
310M100US32220,32220,2010,22875,17452,5423
310M100US32220,32220,2011,24238,18074,6164
310M100US32220,32220,2012,24368,17694,6674
310M200US32220,32220,2013,23148,17167,5981
310M200US32220,32220,2014,22997,17236,5761
310M200US32220,32220,2015,22227,16460,5767
310M300US32220,32220,2016,23742,17035,6707
3100000US32270,32270,2006,31273,25430,5843
3100000US32270,32270,2007,32069,24736,7333
3100000US32270,32270,2008,32118,24099,8019
3100000US32270,32270,2009,31914,23881,8033
310M100US32270,32270,2010,32098,23722,8376
310M100US32270,32270,2011,32045,23920,8125
310M100US32270,32270,2012,31549,23772,7777
3100000US32300,32300,2006,28916,23059,5857
3100000US32300,32300,2007,28156,19504,8652
3100000US32300,32300,2008,30193,21651,8542
3100000US32300,32300,2009,30021,21560,8461
310M100US32300,32300,2010,27660,19168,8492
310M100US32300,32300,2011,29310,20717,8593
310M100US32300,32300,2012,27623,19798,7825
310M200US32300,32300,2013,29608,19607,10001
310M200US32300,32300,2014,27434,20497,6937
310M200US32300,32300,2015,26719,18693,8026
310M300US32300,32300,2016,28162,19718,8444
3100000US32420,32420,2006,39096,26620,12476
3100000US32420,32420,2007,39301,25202,14099
3100000US32420,32420,2008,38219,23130,15089
3100000US32420,32420,2009,37291,23170,14121
310M100US32420,32420,2010,39696,25006,14690
310M100US32420,32420,2011,38386,23313,15073
310M100US32420,32420,2012,37206,23700,13506
310M200US32420,32420,2013,36919,22163,14756
310M200US32420,32420,2014,35134,21854,13280
310M200US32420,32420,2015,36870,22964,13906
310M300US32420,32420,2016,35033,20438,14595
3100000US32580,32580,2006,202984,143997,58987
3100000US32580,32580,2007,206938,145968,60970
3100000US32580,32580,2008,211551,146759,64792
3100000US32580,32580,2009,219915,151739,68176
310M100US32580,32580,2010,212743,144759,67984
310M100US32580,32580,2011,215877,148080,67797
310M100US32580,32580,2012,222849,149877,72972
310M200US32580,32580,2013,223367,150505,72862
310M200US32580,32580,2014,226000,153696,72304
310M200US32580,32580,2015,225692,156841,68851
310M300US32580,32580,2016,234716,155421,79295
3100000US32740,32740,2006,34254,25803,8451
3100000US32740,32740,2007,34629,26575,8054
3100000US32740,32740,2008,35215,25518,9697
3100000US32740,32740,2009,35280,26246,9034
310M100US32740,32740,2010,35203,25566,9637
310M100US32740,32740,2011,34898,25824,9074
310M100US32740,32740,2012,34792,25773,9019
310M200US32740,32740,2013,33971,25268,8703
310M200US32740,32740,2014,34834,25775,9059
310M200US32740,32740,2015,35781,25575,10206
310M300US32740,32740,2016,33955,25051,8904
3100000US32780,32780,2006,80931,51851,29080
3100000US32780,32780,2007,81616,51301,30315
3100000US32780,32780,2008,82017,50723,31294
3100000US32780,32780,2009,83367,50737,32630
310M100US32780,32780,2010,81508,51962,29546
310M100US32780,32780,2011,84413,48900,35513
310M100US32780,32780,2012,80957,52457,28500
310M200US32780,32780,2013,82983,52097,30886
310M200US32780,32780,2014,83131,51685,31446
310M200US32780,32780,2015,83876,51150,32726
310M300US32780,32780,2016,86745,54242,32503
3100000US32820,32820,2006,472807,313123,159684
3100000US32820,32820,2007,478912,311063,167849
3100000US32820,32820,2008,480876,315696,165180
3100000US32820,32820,2009,480837,307073,173764
310M100US32820,32820,2010,474304,299303,175001
310M100US32820,32820,2011,480654,300126,180528
310M100US32820,32820,2012,484923,301663,183260
310M200US32820,32820,2013,492311,296962,195349
310M200US32820,32820,2014,493329,298459,194870
310M200US32820,32820,2015,494270,295249,199021
310M300US32820,32820,2016,501107,290257,210850
3100000US32900,32900,2006,72180,38913,33267
3100000US32900,32900,2007,73482,41790,31692
3100000US32900,32900,2008,72353,38502,33851
3100000US32900,32900,2009,74166,39947,34219
310M100US32900,32900,2010,73885,40334,33551
310M100US32900,32900,2011,74833,38880,35953
310M100US32900,32900,2012,76451,40931,35520
310M200US32900,32900,2013,77651,40650,37001
310M200US32900,32900,2014,79255,39437,39818
310M200US32900,32900,2015,79098,40476,38622
310M300US32900,32900,2016,77713,40561,37152
3100000US32940,32940,2006,41279,28621,12658
3100000US32940,32940,2007,42468,28708,13760
3100000US32940,32940,2008,41617,27752,13865
3100000US32940,32940,2009,41381,29304,12077
310M100US32940,32940,2010,40483,27867,12616
310M100US32940,32940,2011,37761,26834,10927
310M100US32940,32940,2012,39399,26973,12426
310M200US32940,32940,2013,40820,28045,12775
310M200US32940,32940,2014,39485,26535,12950
310M200US32940,32940,2015,40352,27006,13346
310M300US32940,32940,2016,37269,26790,10479
3100000US33100,33100,2006,2015417,1357812,657605
3100000US33100,33100,2007,2002081,1354306,647775
3100000US33100,33100,2008,1997988,1336139,661849
3100000US33100,33100,2009,1970691,1273300,697391
310M100US33100,33100,2010,1984559,1270349,714210
310M100US33100,33100,2011,2008167,1255102,753065
310M100US33100,33100,2012,2024878,1255837,769041
310M200US33100,33100,2013,2032438,1233136,799302
310M200US33100,33100,2014,2047325,1219261,828064
310M200US33100,33100,2015,2077362,1215228,862134
310M300US33100,33100,2016,2098686,1223752,874934
3100000US33140,33140,2006,42011,31741,10270
3100000US33140,33140,2007,41805,31151,10654
3100000US33140,33140,2008,42012,31529,10483
3100000US33140,33140,2009,43070,32767,10303
310M100US33140,33140,2010,42552,31367,11185
310M100US33140,33140,2011,42075,30674,11401
310M100US33140,33140,2012,43468,30387,13081
310M200US33140,33140,2013,42746,30249,12497
310M200US33140,33140,2014,42068,29052,13016
310M200US33140,33140,2015,43169,30192,12977
310M300US33140,33140,2016,42074,31235,10839
3100000US33220,33220,2006,32646,25027,7619
3100000US33220,33220,2007,32571,25135,7436
3100000US33220,33220,2008,32804,25989,6815
3100000US33220,33220,2009,33614,26198,7416
310M100US33220,33220,2010,33843,24718,9125
310M100US33220,33220,2011,33679,26042,7637
310M100US33220,33220,2012,33235,24615,8620
310M200US33220,33220,2013,33858,25637,8221
310M200US33220,33220,2014,33579,25037,8542
310M200US33220,33220,2015,32977,24908,8069
310M300US33220,33220,2016,34381,25882,8499
3100000US33260,33260,2006,46892,32107,14785
3100000US33260,33260,2007,46747,32097,14650
3100000US33260,33260,2008,46959,33079,13880
3100000US33260,33260,2009,46563,32277,14286
310M100US33260,33260,2010,48730,33662,15068
310M100US33260,33260,2011,50842,33886,16956
310M100US33260,33260,2012,51216,34107,17109
310M200US33260,33260,2013,54082,34201,19881
310M200US33260,33260,2014,55814,36989,18825
310M200US33260,33260,2015,57867,41043,16824
310M300US33260,33260,2016,57814,36245,21569
3100000US33340,33340,2006,605162,386711,218451
3100000US33340,33340,2007,605769,386841,218928
3100000US33340,33340,2008,606682,387131,219551
3100000US33340,33340,2009,604566,376925,227641
310M100US33340,33340,2010,615244,382725,232519
310M100US33340,33340,2011,615107,371781,243326
310M100US33340,33340,2012,623682,373765,249917
310M200US33340,33340,2013,622962,377065,245897
310M200US33340,33340,2014,626248,373101,253147
310M200US33340,33340,2015,627842,369539,258303
310M300US33340,33340,2016,626328,374950,251378
3100000US33460,33460,2006,1232889,927748,305141
3100000US33460,33460,2007,1246042,924184,321858
3100000US33460,33460,2008,1262247,931880,330367
3100000US33460,33460,2009,1259095,911984,347111
310M100US33460,33460,2010,1267805,903778,364027
310M100US33460,33460,2011,1281260,904981,376279
310M100US33460,33460,2012,1296603,900327,396276
310M200US33460,33460,2013,1332110,925512,406598
310M200US33460,33460,2014,1337263,935151,402112
310M200US33460,33460,2015,1354766,933390,421376
310M300US33460,33460,2016,1363277,942801,420476
3100000US33500,33500,2009,28366,19472,8894
310M100US33500,33500,2010,28515,19116,9399
310M100US33500,33500,2011,27980,18275,9705
310M100US33500,33500,2012,28554,18760,9794
310M200US33500,33500,2013,30329,18125,12204
310M200US33500,33500,2014,30112,19553,10559
310M200US33500,33500,2015,31366,20079,11287
310M300US33500,33500,2016,31479,19467,12012
3100000US33540,33540,2006,40491,24022,16469
3100000US33540,33540,2007,40979,26283,14696
3100000US33540,33540,2008,43751,27500,16251
3100000US33540,33540,2009,42475,24467,18008
310M100US33540,33540,2010,44572,28151,16421
310M100US33540,33540,2011,45680,26138,19542
310M100US33540,33540,2012,46384,26975,19409
310M200US33540,33540,2013,45820,26109,19711
310M200US33540,33540,2014,46407,27080,19327
310M200US33540,33540,2015,47910,28124,19786
310M300US33540,33540,2016,47725,28418,19307
3100000US33660,33660,2006,149552,104726,44826
3100000US33660,33660,2007,153894,104215,49679
3100000US33660,33660,2008,160153,110074,50079
3100000US33660,33660,2009,162613,106356,56257
310M100US33660,33660,2010,153676,103152,50524
310M100US33660,33660,2011,157783,106764,51019
310M100US33660,33660,2012,156755,100690,56065
310M200US33660,33660,2013,148025,98085,49940
310M200US33660,33660,2014,153450,100101,53349
310M200US33660,33660,2015,152938,100028,52910
310M300US33660,33660,2016,157141,103022,54119
3100000US33700,33700,2006,160431,102731,57700
3100000US33700,33700,2007,157262,100425,56837
3100000US33700,33700,2008,160855,100049,60806
3100000US33700,33700,2009,161083,96132,64951
310M100US33700,33700,2010,165761,98598,67163
310M100US33700,33700,2011,167860,97147,70713
310M100US33700,33700,2012,167497,93081,74416
310M200US33700,33700,2013,167411,94674,72737
310M200US33700,33700,2014,169038,93436,75602
310M200US33700,33700,2015,171960,97077,74883
310M300US33700,33700,2016,172881,97945,74936
3100000US33740,33740,2006,63792,42333,21459
3100000US33740,33740,2007,60497,39943,20554
3100000US33740,33740,2008,64218,40884,23334
3100000US33740,33740,2009,67080,42945,24135
310M100US33740,33740,2010,65267,41223,24044
310M100US33740,33740,2011,66571,39317,27254
310M100US33740,33740,2012,67742,42277,25465
310M200US33740,33740,2013,65989,41723,24266
310M200US33740,33740,2014,66596,42192,24404
310M200US33740,33740,2015,64955,39981,24974
310M300US33740,33740,2016,62201,36946,25255
3100000US33780,33780,2006,58376,47420,10956
3100000US33780,33780,2007,57333,46434,10899
3100000US33780,33780,2008,58785,46849,11936
3100000US33780,33780,2009,60786,48672,12114
310M100US33780,33780,2010,58596,46148,12448
310M100US33780,33780,2011,57491,45441,12050
310M100US33780,33780,2012,57506,44350,13156
310M200US33780,33780,2013,58479,46015,12464
310M200US33780,33780,2014,57879,45627,12252
310M200US33780,33780,2015,58886,47149,11737
310M300US33780,33780,2016,58789,47059,11730
3100000US33860,33860,2006,137460,94961,42499
3100000US33860,33860,2007,138204,94348,43856
3100000US33860,33860,2008,137791,95560,42231
3100000US33860,33860,2009,137103,93362,43741
310M100US33860,33860,2010,140996,93970,47026
310M100US33860,33860,2011,139181,94730,44451
310M100US33860,33860,2012,142926,93687,49239
310M200US33860,33860,2013,141137,90409,50728
310M200US33860,33860,2014,142432,92267,50165
310M200US33860,33860,2015,144379,91105,53274
310M300US33860,33860,2016,145847,91910,53937
310M100US33980,33980,2010,28356,19498,8858
310M100US33980,33980,2011,28071,18398,9673
310M100US33980,33980,2012,28346,20334,8012
310M200US33980,33980,2013,29961,22385,7576
310M200US33980,33980,2014,28773,20265,8508
310M200US33980,33980,2015,29636,21436,8200
310M300US33980,33980,2016,27506,18732,8774
3100000US34060,34060,2006,43498,30468,13030
3100000US34060,34060,2007,41547,28827,12720
3100000US34060,34060,2008,42959,28239,14720
3100000US34060,34060,2009,44013,28322,15691
310M100US34060,34060,2010,48447,31016,17431
310M100US34060,34060,2011,48078,29482,18596
310M100US34060,34060,2012,49069,29504,19565
310M200US34060,34060,2013,50295,32558,17737
310M200US34060,34060,2014,49804,31959,17845
310M200US34060,34060,2015,50274,31577,18697
310M300US34060,34060,2016,50521,31882,18639
3100000US34100,34100,2006,52168,38108,14060
3100000US34100,34100,2007,50805,37950,12855
3100000US34100,34100,2008,51726,38958,12768
3100000US34100,34100,2009,54243,41364,12879
310M100US34100,34100,2010,52262,37752,14510
310M100US34100,34100,2011,53398,38945,14453
310M100US34100,34100,2012,52341,39457,12884
310M200US34100,34100,2013,42874,29412,13462
310M200US34100,34100,2014,45581,30961,14620
310M200US34100,34100,2015,44574,29886,14688
310M300US34100,34100,2016,43944,30576,13368
3100000US34180,34180,2006,27547,17531,10016
3100000US34180,34180,2007,28216,18143,10073
3100000US34180,34180,2008,28473,16735,11738
3100000US34180,34180,2009,27821,17378,10443
310M100US34180,34180,2010,30228,18787,11441
310M100US34180,34180,2011,31009,17681,13328
310M100US34180,34180,2012,30543,18427,12116
310M200US34180,34180,2013,29888,18012,11876
310M200US34180,34180,2014,29758,17658,12100
310M200US34180,34180,2015,30915,19189,11726
310M300US34180,34180,2016,28351,17319,11032
3100000US34340,34340,2006,27662,19970,7692
3100000US34340,34340,2007,28542,21813,6729
3100000US34340,34340,2008,28806,22065,6741
3100000US34340,34340,2009,29552,22187,7365
310M100US34340,34340,2010,30000,21467,8533
310M100US34340,34340,2011,30856,22041,8815
310M100US34340,34340,2012,29063,21153,7910
310M200US34340,34340,2013,30156,22243,7913
310M200US34340,34340,2014,27632,19649,7983
310M200US34340,34340,2015,29234,20957,8277
310M300US34340,34340,2016,28261,19410,8851
3100000US34380,34380,2006,23673,15456,8217
3100000US34380,34380,2007,24671,14884,9787
3100000US34380,34380,2008,25117,15121,9996
3100000US34380,34380,2009,25908,14846,11062
310M100US34380,34380,2010,25139,14297,10842
310M100US34380,34380,2011,23607,13880,9727
310M100US34380,34380,2012,24663,14668,9995
310M200US34380,34380,2013,25225,15469,9756
310M200US34380,34380,2014,24999,15064,9935
310M200US34380,34380,2015,24246,14581,9665
310M300US34380,34380,2016,23920,15118,8802
3100000US34580,34580,2006,43138,29793,13345
3100000US34580,34580,2007,44037,31580,12457
3100000US34580,34580,2008,44103,31264,12839
3100000US34580,34580,2009,44513,31190,13323
310M100US34580,34580,2010,44856,30823,14033
310M100US34580,34580,2011,45801,29544,16257
310M100US34580,34580,2012,44671,30378,14293
310M200US34580,34580,2013,45234,30736,14498
310M200US34580,34580,2014,45447,30116,15331
310M200US34580,34580,2015,48056,31921,16135
310M300US34580,34580,2016,46423,31625,14798
3100000US34620,34620,2006,45350,30293,15057
3100000US34620,34620,2007,47844,31993,15851
3100000US34620,34620,2008,45071,31208,13863
3100000US34620,34620,2009,45988,29397,16591
310M100US34620,34620,2010,46933,29648,17285
310M100US34620,34620,2011,45477,29423,16054
310M100US34620,34620,2012,46572,28987,17585
310M200US34620,34620,2013,46431,28841,17590
310M200US34620,34620,2014,45207,29485,15722
310M200US34620,34620,2015,45278,29201,16077
310M300US34620,34620,2016,46720,30132,16588
3100000US34740,34740,2006,65635,52063,13572
3100000US34740,34740,2007,64455,49684,14771
3100000US34740,34740,2008,66384,50650,15734
3100000US34740,34740,2009,65509,47983,17526
310M100US34740,34740,2010,65892,47876,18016
310M100US34740,34740,2011,62839,47556,15283
310M100US34740,34740,2012,63860,47301,16559
310M200US34740,34740,2013,65559,48665,16894
310M200US34740,34740,2014,64646,48224,16422
310M200US34740,34740,2015,63215,46354,16861
310M300US34740,34740,2016,65437,47467,17970
3100000US34780,34780,2006,25516,18815,6701
3100000US34780,34780,2007,26334,18302,8032
3100000US34780,34780,2008,27654,18463,9191
3100000US34780,34780,2009,27622,18146,9476
310M100US34780,34780,2010,26664,18874,7790
310M100US34780,34780,2011,26980,18267,8713
310M100US34780,34780,2012,26128,16775,9353
310M200US34780,34780,2013,26529,18134,8395
310M200US34780,34780,2014,26016,17047,8969
310M200US34780,34780,2015,25438,17054,8384
310M300US34780,34780,2016,26000,16870,9130
3100000US34820,34820,2006,106901,74596,32305
3100000US34820,34820,2007,109592,79994,29598
3100000US34820,34820,2008,110356,77677,32679
3100000US34820,34820,2009,110365,79748,30617
310M100US34820,34820,2010,111352,78425,32927
310M100US34820,34820,2011,109447,76256,33191
310M100US34820,34820,2012,118092,79058,39034
310M200US34820,34820,2013,162547,115238,47309
310M200US34820,34820,2014,174999,123608,51391
310M200US34820,34820,2015,174808,124329,50479
310M300US34820,34820,2016,179893,128870,51023
310M100US34860,34860,2011,23198,12108,11090
310M100US34860,34860,2012,24099,13946,10153
310M200US34860,34860,2013,22687,13297,9390
310M200US34860,34860,2014,24734,13242,11492
310M200US34860,34860,2015,23493,12268,11225
310M300US34860,34860,2016,23080,12653,10427
3100000US34900,34900,2006,47854,29915,17939
3100000US34900,34900,2007,49069,32301,16768
3100000US34900,34900,2008,46333,30047,16286
3100000US34900,34900,2009,49014,31298,17716
310M100US34900,34900,2010,49754,30948,18806
310M100US34900,34900,2011,49933,27183,22750
310M100US34900,34900,2012,48224,29220,19004
310M200US34900,34900,2013,47482,29568,17914
310M200US34900,34900,2014,50516,31992,18524
310M200US34900,34900,2015,49619,30665,18954
310M300US34900,34900,2016,49561,31551,18010
3100000US34940,34940,2006,120963,91931,29032
3100000US34940,34940,2007,120309,91487,28822
3100000US34940,34940,2008,117344,90509,26835
3100000US34940,34940,2009,113378,86594,26784
310M100US34940,34940,2010,118258,88290,29968
310M100US34940,34940,2011,123949,91261,32688
310M100US34940,34940,2012,123714,91797,31917
310M200US34940,34940,2013,130614,92720,37894
310M200US34940,34940,2014,133162,95311,37851
310M200US34940,34940,2015,134906,97414,37492
310M300US34940,34940,2016,139522,101132,38390
3100000US34980,34980,2006,574954,396801,178153
3100000US34980,34980,2007,585076,407609,177467
3100000US34980,34980,2008,604174,420165,184009
3100000US34980,34980,2009,598055,405269,192786
310M100US34980,34980,2010,599775,398411,201364
310M100US34980,34980,2011,613496,403456,210040
310M100US34980,34980,2012,616606,398470,218136
310M200US34980,34980,2013,662187,435026,227161
310M200US34980,34980,2014,674665,434943,239722
310M200US34980,34980,2015,686640,451109,235531
310M300US34980,34980,2016,706627,456324,250303
3100000US35100,35100,2006,49071,32463,16608
3100000US35100,35100,2007,49496,34036,15460
3100000US35100,35100,2008,50822,33858,16964
3100000US35100,35100,2009,49627,31275,18352
310M100US35100,35100,2010,49840,32833,17007
310M100US35100,35100,2011,48282,32334,15948
310M100US35100,35100,2012,50760,33896,16864
310M200US35100,35100,2013,48962,31829,17133
310M200US35100,35100,2014,49335,31534,17801
310M200US35100,35100,2015,51013,31294,19719
310M300US35100,35100,2016,49233,33075,16158
3100000US35260,35260,2006,35630,27878,7752
3100000US35260,35260,2007,36348,28436,7912
3100000US35260,35260,2008,35369,27569,7800
3100000US35260,35260,2009,36615,29200,7415
310M100US35260,35260,2010,36484,27049,9435
310M100US35260,35260,2011,36278,27352,8926
310M100US35260,35260,2012,37154,27333,9821
310M200US35260,35260,2013,36354,26757,9597
310M200US35260,35260,2014,35935,26313,9622
310M200US35260,35260,2015,36138,26448,9690
310M300US35260,35260,2016,35861,26352,9509
3100000US35300,35300,2006,320838,212591,108247
3100000US35300,35300,2007,321203,215414,105789
3100000US35300,35300,2008,322436,207430,115006
3100000US35300,35300,2009,321692,206416,115276
310M100US35300,35300,2010,329595,209305,120290
310M100US35300,35300,2011,326523,207792,118731
310M100US35300,35300,2012,330054,209129,120925
310M200US35300,35300,2013,321048,198361,122687
310M200US35300,35300,2014,326050,202343,123707
310M200US35300,35300,2015,323270,198666,124604
310M300US35300,35300,2016,327560,200536,127024
3100000US35340,35340,2006,26152,18409,7743
3100000US35340,35340,2007,26511,17983,8528
3100000US35340,35340,2008,26649,18020,8629
3100000US35340,35340,2009,27306,19523,7783
310M100US35340,35340,2010,26130,18398,7732
310M100US35340,35340,2011,26740,19848,6892
310M100US35340,35340,2012,26359,18795,7564
3100000US35380,35380,2006,353386,241415,111971
3100000US35380,35380,2007,367100,243158,123942
3100000US35380,35380,2008,383802,257207,126595
3100000US35380,35380,2009,435086,285380,149706
310M100US35380,35380,2010,451411,289204,162207
310M100US35380,35380,2011,456878,281381,175497
310M100US35380,35380,2012,463402,280903,182499
310M200US35380,35380,2013,479366,291613,187753
310M200US35380,35380,2014,474715,290398,184317
310M200US35380,35380,2015,481754,289853,191901
310M300US35380,35380,2016,482980,293200,189780
3100000US35420,35420,2006,35255,26773,8482
3100000US35420,35420,2007,36089,26442,9647
3100000US35420,35420,2008,34982,25254,9728
3100000US35420,35420,2009,35459,26060,9399
310M100US35420,35420,2010,34310,26219,8091
310M100US35420,35420,2011,37151,26670,10481
310M100US35420,35420,2012,36699,25763,10936
310M200US35420,35420,2013,34949,25006,9943
310M200US35420,35420,2014,37516,25978,11538
310M200US35420,35420,2015,36511,25234,11277
310M300US35420,35420,2016,34968,24716,10252
3100000US35620,35620,2006,6709151,3609780,3099371
3100000US35620,35620,2007,6721841,3594966,3126875
3100000US35620,35620,2008,6760231,3607190,3153041
3100000US35620,35620,2009,6787155,3577313,3209842
310M100US35620,35620,2010,6800883,3547755,3253128
310M100US35620,35620,2011,6789943,3472909,3317034
310M100US35620,35620,2012,6872526,3529896,3342630
310M200US35620,35620,2013,7080691,3655346,3425345
310M200US35620,35620,2014,7152760,3627096,3525664
310M200US35620,35620,2015,7125065,3621498,3503567
310M300US35620,35620,2016,7118024,3633552,3484472
3100000US35660,35660,2006,61974,44370,17604
3100000US35660,35660,2007,63645,47867,15778
3100000US35660,35660,2008,63978,46446,17532
3100000US35660,35660,2009,63898,45143,18755
310M100US35660,35660,2010,59915,44166,15749
310M100US35660,35660,2011,56676,41916,14760
310M100US35660,35660,2012,60223,43479,16744
310M200US35660,35660,2013,59239,41643,17596
310M200US35660,35660,2014,62984,43026,19958
310M200US35660,35660,2015,64279,44342,19937
310M300US35660,35660,2016,62538,43443,19095
310M100US35840,35840,2010,289448,214390,75058
310M100US35840,35840,2011,307727,220851,86876
310M100US35840,35840,2012,303355,217816,85539
310M200US35840,35840,2013,302518,220364,82154
310M200US35840,35840,2014,313576,219924,93652
310M200US35840,35840,2015,312497,220478,92019
310M300US35840,35840,2016,318656,233637,85019
3100000US35900,35900,2006,25748,19812,5936
3100000US35900,35900,2007,26967,20528,6439
3100000US35900,35900,2008,27564,20862,6702
3100000US35900,35900,2009,26557,18461,8096
310M100US35900,35900,2010,27062,20237,6825
310M100US35900,35900,2011,27853,20279,7574
310M100US35900,35900,2012,28646,22281,6365
310M200US35900,35900,2013,27557,20188,7369
310M200US35900,35900,2014,27257,18679,8578
310M200US35900,35900,2015,27540,20950,6590
310M300US35900,35900,2016,28771,22316,6455
3100000US35980,35980,2006,103662,72397,31265
3100000US35980,35980,2007,102995,72801,30194
3100000US35980,35980,2008,103401,70949,32452
3100000US35980,35980,2009,103623,70908,32715
310M100US35980,35980,2010,106808,73118,33690
310M100US35980,35980,2011,108239,74577,33662
310M100US35980,35980,2012,105801,69260,36541
310M200US35980,35980,2013,106886,70733,36153
310M200US35980,35980,2014,105504,70479,35025
310M200US35980,35980,2015,105376,68606,36770
310M300US35980,35980,2016,105113,69554,35559
3100000US36020,36020,2006,30966,24422,6544
3100000US36020,36020,2007,31359,23236,8123
3100000US36020,36020,2008,32250,24350,7900
3100000US36020,36020,2009,31710,23283,8427
310M100US36020,36020,2010,32685,23131,9554
310M100US36020,36020,2011,32932,23095,9837
310M100US36020,36020,2012,32954,21627,11327
310M200US36020,36020,2013,32990,22639,10351
310M200US36020,36020,2014,32464,20961,11503
310M200US36020,36020,2015,32939,23142,9797
310M300US36020,36020,2016,33365,22280,11085
3100000US36100,36100,2006,130130,101381,28749
3100000US36100,36100,2007,128822,100986,27836
3100000US36100,36100,2008,136226,101879,34347
3100000US36100,36100,2009,134545,106056,28489
310M100US36100,36100,2010,131753,103237,28516
310M100US36100,36100,2011,133433,100836,32597
310M100US36100,36100,2012,133910,99793,34117
310M200US36100,36100,2013,133098,98699,34399
310M200US36100,36100,2014,132275,100578,31697
310M200US36100,36100,2015,125227,95212,30015
310M300US36100,36100,2016,134239,95971,38268
3100000US36140,36140,2006,45715,33571,12144
3100000US36140,36140,2007,46717,33841,12876
3100000US36140,36140,2008,47356,35975,11381
3100000US36140,36140,2009,46989,31715,15274
310M100US36140,36140,2010,42763,32537,10226
310M100US36140,36140,2011,41082,30796,10286
310M100US36140,36140,2012,40470,29689,10781
310M200US36140,36140,2013,38210,30288,7922
310M200US36140,36140,2014,40779,30995,9784
310M200US36140,36140,2015,38708,29608,9100
310M300US36140,36140,2016,38895,29822,9073
3100000US36220,36220,2006,45526,32697,12829
3100000US36220,36220,2007,45936,33205,12731
3100000US36220,36220,2008,46053,30855,15198
3100000US36220,36220,2009,48671,30526,18145
310M100US36220,36220,2010,48630,30338,18292
310M100US36220,36220,2011,49905,32943,16962
310M100US36220,36220,2012,49382,34096,15286
310M200US36220,36220,2013,51962,33665,18297
310M200US36220,36220,2014,50724,31892,18832
310M200US36220,36220,2015,52023,35752,16271
310M300US36220,36220,2016,51012,32908,18104
3100000US36260,36260,2006,158848,121405,37443
3100000US36260,36260,2007,163994,126300,37694
3100000US36260,36260,2008,169217,129945,39272
3100000US36260,36260,2009,171744,131141,40603
310M100US36260,36260,2010,177989,131723,46266
310M100US36260,36260,2011,178441,134171,44270
310M100US36260,36260,2012,179915,134535,45380
310M200US36260,36260,2013,195180,145415,49765
310M200US36260,36260,2014,199206,148454,50752
310M200US36260,36260,2015,201165,149092,52073
310M300US36260,36260,2016,203877,155602,48275
3100000US36300,36300,2006,40886,29350,11536
3100000US36300,36300,2007,40472,29508,10964
3100000US36300,36300,2008,42592,28932,13660
3100000US36300,36300,2009,41645,28738,12907
310M100US36300,36300,2010,43123,30370,12753
310M100US36300,36300,2011,40937,29562,11375
310M100US36300,36300,2012,42436,29582,12854
310M200US36300,36300,2013,41299,29530,11769
310M200US36300,36300,2014,40286,28625,11661
310M200US36300,36300,2015,42771,30520,12251
310M300US36300,36300,2016,40479,30002,10477
3100000US36420,36420,2006,457291,305735,151556
3100000US36420,36420,2007,462867,308177,154690
3100000US36420,36420,2008,464491,305807,158684
3100000US36420,36420,2009,472088,308436,163652
310M100US36420,36420,2010,474558,314101,160457
310M100US36420,36420,2011,483385,313979,169406
310M100US36420,36420,2012,484733,311561,173172
310M200US36420,36420,2013,493315,312877,180438
310M200US36420,36420,2014,499878,316102,183776
310M200US36420,36420,2015,505074,322907,182167
310M300US36420,36420,2016,510666,323189,187477
3100000US36460,36460,2006,32792,23962,8830
3100000US36460,36460,2007,32070,22665,9405
3100000US36460,36460,2008,32582,24302,8280
3100000US36460,36460,2009,33727,24577,9150
310M100US36460,36460,2010,32183,23706,8477
310M100US36460,36460,2011,31938,22086,9852
310M100US36460,36460,2012,32347,23456,8891
310M200US36460,36460,2013,32271,22613,9658
310M200US36460,36460,2014,30735,21824,8911
310M200US36460,36460,2015,31174,21556,9618
310M300US36460,36460,2016,31409,22810,8599
3100000US36500,36500,2006,92293,62210,30083
3100000US36500,36500,2007,94855,61719,33136
3100000US36500,36500,2008,97122,65528,31594
3100000US36500,36500,2009,96702,67159,29543
310M100US36500,36500,2010,99869,65797,34072
310M100US36500,36500,2011,101970,67622,34348
310M100US36500,36500,2012,102335,67658,34677
310M200US36500,36500,2013,99815,63501,36314
310M200US36500,36500,2014,103319,62308,41011
310M200US36500,36500,2015,105159,67682,37477
310M300US36500,36500,2016,105863,66783,39080
3100000US36540,36540,2006,319229,217190,102039
3100000US36540,36540,2007,320097,220625,99472
3100000US36540,36540,2008,328004,224008,103996
3100000US36540,36540,2009,328042,220081,107961
310M100US36540,36540,2010,334319,226908,107411
310M100US36540,36540,2011,334671,222474,112197
310M100US36540,36540,2012,341740,224041,117699
310M200US36540,36540,2013,343054,222153,120901
310M200US36540,36540,2014,346283,225074,121209
310M200US36540,36540,2015,351446,231174,120272
310M300US36540,36540,2016,352723,228111,124612
3100000US36660,36660,2006,31608,21179,10429
3100000US36660,36660,2007,31720,22658,9062
3100000US36660,36660,2008,33097,23965,9132
3100000US36660,36660,2009,33317,23022,10295
310M100US36660,36660,2010,30518,22060,8458
310M100US36660,36660,2011,31238,21393,9845
310M100US36660,36660,2012,30937,21703,9234
310M200US36660,36660,2013,31698,21726,9972
310M200US36660,36660,2014,28739,20846,7893
310M200US36660,36660,2015,30512,20828,9684
310M300US36660,36660,2016,30302,20522,9780
3100000US36700,36700,2006,33207,23006,10201
3100000US36700,36700,2007,34010,23366,10644
3100000US36700,36700,2008,34326,23630,10696
3100000US36700,36700,2009,33746,22909,10837
310M100US36700,36700,2010,33789,22532,11257
310M100US36700,36700,2011,33275,22809,10466
310M100US36700,36700,2012,34286,23481,10805
310M200US36700,36700,2013,32915,21827,11088
310M200US36700,36700,2014,31350,20099,11251
310M200US36700,36700,2015,33175,23375,9800
310M300US36700,36700,2016,33449,21726,11723
3100000US36740,36740,2006,749928,499710,250218
3100000US36740,36740,2007,759218,510260,248958
3100000US36740,36740,2008,749772,504313,245459
3100000US36740,36740,2009,740669,489783,250886
310M100US36740,36740,2010,748210,486307,261903
310M100US36740,36740,2011,765469,479215,286254
310M100US36740,36740,2012,778693,478048,300645
310M200US36740,36740,2013,780174,473787,306387
310M200US36740,36740,2014,800299,478030,322269
310M200US36740,36740,2015,845295,503804,341491
310M300US36740,36740,2016,862521,511658,350863
3100000US36780,36780,2006,66874,44960,21914
3100000US36780,36780,2007,64415,45316,19099
3100000US36780,36780,2008,63144,44411,18733
3100000US36780,36780,2009,67425,44604,22821
310M100US36780,36780,2010,67793,45467,22326
310M100US36780,36780,2011,68069,45225,22844
310M100US36780,36780,2012,67627,45373,22254
310M200US36780,36780,2013,68985,43929,25056
310M200US36780,36780,2014,69417,44443,24974
310M200US36780,36780,2015,69636,45030,24606
310M300US36780,36780,2016,69943,45246,24697
3100000US36860,36860,2006,63287,47372,15915
3100000US36860,36860,2007,62962,46197,16765
3100000US36860,36860,2008,62077,46714,15363
3100000US36860,36860,2009,60667,46445,14222
310M100US36860,36860,2010,59975,45392,14583
310M100US36860,36860,2011,59879,45034,14845
310M100US36860,36860,2012,61510,45941,15569
310M200US36860,36860,2013,59498,44424,15074
310M200US36860,36860,2014,59853,44390,15463
310M200US36860,36860,2015,61678,44602,17076
310M300US36860,36860,2016,60800,44790,16010
3100000US36980,36980,2006,45767,33507,12260
3100000US36980,36980,2007,46296,32326,13970
3100000US36980,36980,2008,46817,32493,14324
3100000US36980,36980,2009,45397,30676,14721
310M100US36980,36980,2010,44507,31310,13197
310M100US36980,36980,2011,43107,31986,11121
310M100US36980,36980,2012,46026,32758,13268
310M200US36980,36980,2013,45776,32593,13183
310M200US36980,36980,2014,46540,30992,15548
310M200US36980,36980,2015,46415,33153,13262
310M300US36980,36980,2016,46803,33412,13391
3100000US37020,37020,2006,27440,21715,5725
3100000US37020,37020,2007,28256,21474,6782
3100000US37020,37020,2008,27595,21876,5719
3100000US37020,37020,2009,27353,20750,6603
310M100US37020,37020,2010,27134,21706,5428
310M100US37020,37020,2011,27333,20345,6988
310M100US37020,37020,2012,27132,21067,6065
310M200US37020,37020,2013,28093,21042,7051
310M200US37020,37020,2014,27285,19610,7675
310M200US37020,37020,2015,27036,20754,6282
310M300US37020,37020,2016,28071,21367,6704
3100000US37100,37100,2006,259093,177961,81132
3100000US37100,37100,2007,255668,173223,82445
3100000US37100,37100,2008,256944,170236,86708
3100000US37100,37100,2009,260249,169308,90941
310M100US37100,37100,2010,265904,170124,95780
310M100US37100,37100,2011,265492,173534,91958
310M100US37100,37100,2012,267877,172028,95849
310M200US37100,37100,2013,265788,168134,97654
310M200US37100,37100,2014,269869,170193,99676
310M200US37100,37100,2015,269566,170602,98964
310M300US37100,37100,2016,268091,166511,101580
3100000US37140,37140,2006,41494,29516,11978
3100000US37140,37140,2007,40863,31124,9739
3100000US37140,37140,2008,41520,30462,11058
3100000US37140,37140,2009,42119,29267,12852
310M100US37140,37140,2010,39182,28687,10495
310M100US37140,37140,2011,39595,28841,10754
310M100US37140,37140,2012,41442,29205,12237
310M200US37140,37140,2013,38938,27874,11064
310M200US37140,37140,2014,41394,27730,13664
310M200US37140,37140,2015,40905,28590,12315
310M300US37140,37140,2016,41521,28443,13078
3100000US37260,37260,2006,27612,20903,6709
3100000US37260,37260,2007,28237,21798,6439
3100000US37260,37260,2008,27298,21473,5825
3100000US37260,37260,2009,27062,20095,6967
310M100US37260,37260,2010,29093,22859,6234
310M100US37260,37260,2011,28353,21096,7257
310M100US37260,37260,2012,28230,20522,7708
310M200US37260,37260,2013,25806,19670,6136
310M200US37260,37260,2014,26580,19535,7045
310M200US37260,37260,2015,28165,19593,8572
310M300US37260,37260,2016,28025,20320,7705
3100000US37340,37340,2006,220587,172059,48528
3100000US37340,37340,2007,216879,166884,49995
3100000US37340,37340,2008,217467,163647,53820
3100000US37340,37340,2009,220290,161112,59178
310M100US37340,37340,2010,221945,166377,55568
310M100US37340,37340,2011,216180,157470,58710
310M100US37340,37340,2012,218094,158941,59153
310M200US37340,37340,2013,218325,156275,62050
310M200US37340,37340,2014,225226,156191,69035
310M200US37340,37340,2015,225682,158025,67657
310M300US37340,37340,2016,226021,163354,62667
3100000US37380,37380,2006,38022,29367,8655
3100000US37380,37380,2007,37935,30013,7922
3100000US37380,37380,2008,37383,28753,8630
3100000US37380,37380,2009,35459,27980,7479
310M100US37380,37380,2010,35218,28689,6529
310M100US37380,37380,2011,34434,26159,8275
310M100US37380,37380,2012,36358,27600,8758
3100000US37460,37460,2006,72304,45631,26673
3100000US37460,37460,2007,71993,49120,22873
3100000US37460,37460,2008,69693,45563,24130
3100000US37460,37460,2009,65948,43163,22785
310M100US37460,37460,2010,63654,40461,23193
310M100US37460,37460,2011,69884,43511,26373
310M100US37460,37460,2012,68653,41100,27553
310M200US37460,37460,2013,69032,42264,26768
310M200US37460,37460,2014,71161,44901,26260
310M200US37460,37460,2015,74276,46108,28168
310M300US37460,37460,2016,75906,49516,26390
3100000US37620,37620,2006,66058,47742,18316
3100000US37620,37620,2007,67351,48645,18706
3100000US37620,37620,2008,67315,50022,17293
3100000US37620,37620,2009,65300,49411,15889
310M100US37620,37620,2010,65240,50066,15174
310M100US37620,37620,2011,64404,48564,15840
310M100US37620,37620,2012,66271,49144,17127
310M200US37620,37620,2013,38799,27795,11004
310M200US37620,37620,2014,38667,27047,11620
310M200US37620,37620,2015,39349,27014,12335
310M300US37620,37620,2016,37097,25999,11098
3100000US37700,37700,2006,53544,40182,13362
3100000US37700,37700,2007,57229,41586,15643
3100000US37700,37700,2008,58233,43653,14580
3100000US37700,37700,2009,54789,39141,15648
310M100US37700,37700,2010,57593,42770,14823
310M100US37700,37700,2011,60037,43581,16456
310M100US37700,37700,2012,58424,43031,15393
3100000US37820,37820,2006,29146,18719,10427
3100000US37820,37820,2007,30617,19342,11275
3100000US37820,37820,2008,30081,19304,10777
3100000US37820,37820,2009,29527,21114,8413
310M100US37820,37820,2010,30973,19435,11538
310M100US37820,37820,2011,30915,19901,11014
310M100US37820,37820,2012,29810,19754,10056
3100000US37860,37860,2006,167049,119242,47807
3100000US37860,37860,2007,167848,121257,46591
3100000US37860,37860,2008,165965,120253,45712
3100000US37860,37860,2009,166970,113297,53673
310M100US37860,37860,2010,165645,115562,50083
310M100US37860,37860,2011,165343,113453,51890
310M100US37860,37860,2012,172413,110511,61902
310M200US37860,37860,2013,172663,111930,60733
310M200US37860,37860,2014,171179,107767,63412
310M200US37860,37860,2015,177675,114246,63429
310M300US37860,37860,2016,180519,119229,61290
3100000US37900,37900,2006,148724,109114,39610
3100000US37900,37900,2007,148478,108727,39751
3100000US37900,37900,2008,151183,114032,37151
3100000US37900,37900,2009,150233,108700,41533
310M100US37900,37900,2010,150898,110593,40305
310M100US37900,37900,2011,151769,108322,43447
310M100US37900,37900,2012,152743,107473,45270
310M200US37900,37900,2013,152051,106017,46034
310M200US37900,37900,2014,149515,106982,42533
310M200US37900,37900,2015,150639,109021,41618
310M300US37900,37900,2016,151258,108106,43152
3100000US37980,37980,2006,2160502,1533934,626568
3100000US37980,37980,2007,2188173,1543543,644630
3100000US37980,37980,2008,2204131,1537739,666392
3100000US37980,37980,2009,2194101,1526350,667751
310M100US37980,37980,2010,2220711,1523951,696760
310M100US37980,37980,2011,2220655,1508676,711979
310M100US37980,37980,2012,2227140,1503234,723906
310M200US37980,37980,2013,2218312,1483780,734532
310M200US37980,37980,2014,2230807,1493966,736841
310M200US37980,37980,2015,2233752,1500566,733186
310M300US37980,37980,2016,2241237,1493426,747811
3100000US38060,38060,2006,1427108,979314,447794
3100000US38060,38060,2007,1449957,993737,456220
3100000US38060,38060,2008,1461699,1000142,461557
3100000US38060,38060,2009,1472149,976778,495371
310M100US38060,38060,2010,1503107,966014,537093
310M100US38060,38060,2011,1529943,957874,572069
310M100US38060,38060,2012,1551267,954941,596326
310M200US38060,38060,2013,1553429,948161,605268
310M200US38060,38060,2014,1590240,947320,642920
310M200US38060,38060,2015,1608722,973044,635678
310M300US38060,38060,2016,1653483,1020703,632780
3100000US38220,38220,2006,37495,25423,12072
3100000US38220,38220,2007,36610,22802,13808
3100000US38220,38220,2008,35882,24254,11628
3100000US38220,38220,2009,38151,24535,13616
310M100US38220,38220,2010,35976,22755,13221
310M100US38220,38220,2011,36652,24604,12048
310M100US38220,38220,2012,35581,23082,12499
310M200US38220,38220,2013,35484,23579,11905
310M200US38220,38220,2014,35978,23608,12370
310M200US38220,38220,2015,34059,22063,11996
310M300US38220,38220,2016,33901,21250,12651
310M200US38240,38240,2013,36502,27127,9375
310M200US38240,38240,2014,37179,27954,9225
310M200US38240,38240,2015,38639,27614,11025
310M300US38240,38240,2016,38786,29113,9673
3100000US38300,38300,2006,980765,701751,279014
3100000US38300,38300,2007,981110,705721,275389
3100000US38300,38300,2008,987110,702054,285056
3100000US38300,38300,2009,997768,700033,297735
310M100US38300,38300,2010,978959,688975,289984
310M100US38300,38300,2011,980405,679166,301239
310M100US38300,38300,2012,990931,688195,302736
310M200US38300,38300,2013,988106,689627,298479
310M200US38300,38300,2014,991951,687677,304274
310M200US38300,38300,2015,990355,685167,305188
310M300US38300,38300,2016,984297,686365,297932
3100000US38340,38340,2006,55272,37398,17874
3100000US38340,38340,2007,55946,37902,18044
3100000US38340,38340,2008,57455,38576,18879
3100000US38340,38340,2009,54148,36073,18075
310M100US38340,38340,2010,56517,37402,19115
310M100US38340,38340,2011,55230,38806,16424
310M100US38340,38340,2012,55420,37226,18194
310M200US38340,38340,2013,54963,37343,17620
310M200US38340,38340,2014,54706,36993,17713
310M200US38340,38340,2015,55497,36422,19075
310M300US38340,38340,2016,54204,37338,16866
3100000US38460,38460,2006,29439,20783,8656
3100000US38460,38460,2007,30408,22316,8092
3100000US38460,38460,2008,30082,21223,8859
3100000US38460,38460,2009,31523,21586,9937
310M100US38460,38460,2010,31659,20501,11158
310M100US38460,38460,2011,32323,21909,10414
310M100US38460,38460,2012,32451,21956,10495
310M200US38460,38460,2013,31862,21673,10189
310M200US38460,38460,2014,31426,21734,9692
310M200US38460,38460,2015,31249,20480,10769
310M300US38460,38460,2016,30624,21466,9158
3100000US38540,38540,2006,31450,22406,9044
3100000US38540,38540,2007,32075,22952,9123
3100000US38540,38540,2008,31327,22592,8735
3100000US38540,38540,2009,32698,24096,8602
310M100US38540,38540,2010,31856,22147,9709
310M100US38540,38540,2011,32813,21558,11255
310M100US38540,38540,2012,33239,22373,10866
310M200US38540,38540,2013,30265,19947,10318
310M200US38540,38540,2014,30240,21363,8877
310M200US38540,38540,2015,30174,18848,11326
310M300US38540,38540,2016,30106,21402,8704
3100000US38660,38660,2006,79776,58165,21611
3100000US38660,38660,2007,77532,55751,21781
3100000US38660,38660,2008,77993,54142,23851
3100000US38660,38660,2009,77385,54356,23029
310M100US38660,38660,2010,83824,58714,25110
310M100US38660,38660,2011,82840,58190,24650
310M100US38660,38660,2012,81723,57207,24516
310M200US38660,38660,2013,112269,79458,32811
310M200US38660,38660,2014,107856,73562,34294
310M200US38660,38660,2015,104647,71976,32671
310M300US38660,38660,2016,105240,72418,32822
3100000US38820,38820,2006,30789,22098,8691
3100000US38820,38820,2007,30700,21148,9552
3100000US38820,38820,2008,29587,19990,9597
3100000US38820,38820,2009,29997,22247,7750
310M100US38820,38820,2010,30430,20291,10139
310M100US38820,38820,2011,31458,22740,8718
310M100US38820,38820,2012,30044,21016,9028
310M200US38820,38820,2013,30606,20606,10000
310M200US38820,38820,2014,31361,22532,8829
310M200US38820,38820,2015,32231,21858,10373
310M300US38820,38820,2016,31837,22693,9144
3100000US38860,38860,2006,210844,153146,57698
3100000US38860,38860,2007,207405,151701,55704
3100000US38860,38860,2008,212774,150848,61926
3100000US38860,38860,2009,209432,149317,60115
310M100US38860,38860,2010,209787,151267,58520
310M100US38860,38860,2011,211202,146829,64373
310M100US38860,38860,2012,213459,148952,64507
310M200US38860,38860,2013,213413,148467,64946
310M200US38860,38860,2014,215232,151758,63474
310M200US38860,38860,2015,212240,149769,62471
310M300US38860,38860,2016,216799,151344,65455
3100000US38900,38900,2006,819196,532659,286537
3100000US38900,38900,2007,833728,543024,290704
3100000US38900,38900,2008,835028,545628,289400
3100000US38900,38900,2009,847989,526468,321521
310M100US38900,38900,2010,857389,530272,327117
310M100US38900,38900,2011,872423,530331,342092
310M100US38900,38900,2012,872878,528225,344653
310M200US38900,38900,2013,881822,531402,350420
310M200US38900,38900,2014,894801,532664,362137
310M200US38900,38900,2015,901402,550790,350612
310M300US38900,38900,2016,918590,566813,351777
3100000US38940,38940,2006,157944,124078,33866
3100000US38940,38940,2007,162151,123432,38719
3100000US38940,38940,2008,154764,117756,37008
3100000US38940,38940,2009,155612,118447,37165
310M100US38940,38940,2010,165072,124846,40226
310M100US38940,38940,2011,164108,124609,39499
310M100US38940,38940,2012,170309,123334,46975
310M200US38940,38940,2013,165882,116683,49199
310M200US38940,38940,2014,171289,129442,41847
310M200US38940,38940,2015,173912,126857,47055
310M300US38940,38940,2016,174593,126602,47991
3100000US39020,39020,2006,30952,21288,9664
3100000US39020,39020,2007,30300,20818,9482
3100000US39020,39020,2008,30593,21999,8594
3100000US39020,39020,2009,30866,21099,9767
310M100US39020,39020,2010,29414,20848,8566
310M100US39020,39020,2011,28818,19238,9580
310M100US39020,39020,2012,28927,19905,9022
310M200US39020,39020,2013,29356,19903,9453
310M200US39020,39020,2014,30790,20842,9948
310M200US39020,39020,2015,30477,21035,9442
310M300US39020,39020,2016,29904,20311,9593
3100000US39060,39060,2006,61148,47883,13265
3100000US39060,39060,2007,59183,46297,12886
3100000US39060,39060,2008,61082,45860,15222
3100000US39060,39060,2009,61307,46456,14851
310M100US39060,39060,2010,60449,46778,13671
310M100US39060,39060,2011,60018,46013,14005
310M100US39060,39060,2012,59338,43579,15759
310M200US39060,39060,2013,58467,42345,16122
310M200US39060,39060,2014,58061,43704,14357
310M200US39060,39060,2015,57392,43835,13557
310M300US39060,39060,2016,58149,43452,14697
3100000US39100,39100,2006,226176,159690,66486
3100000US39100,39100,2007,225258,163120,62138
3100000US39100,39100,2008,225437,157899,67538
3100000US39100,39100,2009,228996,160811,68185
310M100US39100,39100,2010,231561,161651,69910
310M100US39100,39100,2011,232906,158795,74111
310M100US39100,39100,2012,232334,160769,71565
3100000US39140,39140,2006,85244,61239,24005
3100000US39140,39140,2007,85295,60289,25006
3100000US39140,39140,2008,88550,62572,25978
3100000US39140,39140,2009,87846,64789,23057
310M100US39140,39140,2010,90607,62501,28106
310M100US39140,39140,2011,91407,64233,27174
310M100US39140,39140,2012,93697,63539,30158
310M200US39140,39140,2013,91064,60360,30704
310M200US39140,39140,2014,90584,64645,25939
310M200US39140,39140,2015,94920,66820,28100
310M300US39140,39140,2016,94962,69791,25171
3100000US39300,39300,2006,613641,387417,226224
3100000US39300,39300,2007,612509,390487,222022
3100000US39300,39300,2008,603561,380434,223127
3100000US39300,39300,2009,612182,391319,220863
310M100US39300,39300,2010,612291,375307,236984
310M100US39300,39300,2011,621515,381035,240480
310M100US39300,39300,2012,622066,377124,244942
310M200US39300,39300,2013,618975,375241,243734
310M200US39300,39300,2014,622555,371101,251454
310M200US39300,39300,2015,622607,372228,250379
310M300US39300,39300,2016,622471,370275,252196
3100000US39340,39340,2006,130458,89299,41159
3100000US39340,39340,2007,133842,94605,39237
3100000US39340,39340,2008,137542,98925,38617
3100000US39340,39340,2009,139271,97817,41454
310M100US39340,39340,2010,143324,99493,43831
310M100US39340,39340,2011,146320,97377,48943
310M100US39340,39340,2012,147329,98772,48557
310M200US39340,39340,2013,149549,99172,50377
310M200US39340,39340,2014,154567,104176,50391
310M200US39340,39340,2015,158270,106725,51545
310M300US39340,39340,2016,160979,108250,52729
3100000US39380,39380,2006,59314,40553,18761
3100000US39380,39380,2007,59093,43292,15801
3100000US39380,39380,2008,60786,40924,19862
3100000US39380,39380,2009,59987,41070,18917
310M100US39380,39380,2010,62686,42320,20366
310M100US39380,39380,2011,62181,40641,21540
310M100US39380,39380,2012,62388,39865,22523
310M200US39380,39380,2013,62604,39794,22810
310M200US39380,39380,2014,63385,41373,22012
310M200US39380,39380,2015,61876,39237,22639
310M300US39380,39380,2016,62275,40340,21935
3100000US39460,39460,2006,71026,58912,12114
3100000US39460,39460,2007,70871,58457,12414
3100000US39460,39460,2008,73937,57028,16909
3100000US39460,39460,2009,75902,58387,17515
310M100US39460,39460,2010,69176,53788,15388
310M100US39460,39460,2011,68252,53067,15185
310M100US39460,39460,2012,71811,57270,14541
310M200US39460,39460,2013,69035,54274,14761
310M200US39460,39460,2014,75234,59565,15669
310M200US39460,39460,2015,72671,55131,17540
310M300US39460,39460,2016,75147,58478,16669
3100000US39500,39500,2006,32155,22733,9422
3100000US39500,39500,2007,30934,22903,8031
3100000US39500,39500,2008,30314,22426,7888
3100000US39500,39500,2009,32854,23987,8867
310M100US39500,39500,2010,30272,21270,9002
310M100US39500,39500,2011,29967,22067,7900
310M100US39500,39500,2012,30703,22209,8494
310M200US39500,39500,2013,30647,19665,10982
310M200US39500,39500,2014,31347,21870,9477
310M200US39500,39500,2015,30421,21771,8650
310M300US39500,39500,2016,30899,22190,8709
3100000US39540,39540,2006,75154,53026,22128
3100000US39540,39540,2007,74524,52149,22375
3100000US39540,39540,2008,75062,53691,21371
3100000US39540,39540,2009,76016,52196,23820
310M100US39540,39540,2010,74808,51764,23044
310M100US39540,39540,2011,75903,51501,24402
310M100US39540,39540,2012,75752,51845,23907
310M200US39540,39540,2013,72057,51084,20973
310M200US39540,39540,2014,75876,52009,23867
310M200US39540,39540,2015,74960,52292,22668
310M300US39540,39540,2016,75921,49144,26777
3100000US39580,39580,2006,369171,249494,119677
3100000US39580,39580,2007,393260,270210,123050
3100000US39580,39580,2008,401412,275515,125897
3100000US39580,39580,2009,409166,280347,128819
310M100US39580,39580,2010,421955,287129,134826
310M100US39580,39580,2011,425406,289015,136391
310M100US39580,39580,2012,441987,286833,155154
310M200US39580,39580,2013,449589,291693,157896
310M200US39580,39580,2014,457547,294801,162746
310M200US39580,39580,2015,470527,303885,166642
310M300US39580,39580,2016,477920,307639,170281
3100000US39660,39660,2006,47127,33798,13329
3100000US39660,39660,2007,47930,32945,14985
3100000US39660,39660,2008,50824,33427,17397
3100000US39660,39660,2009,49151,34132,15019
310M100US39660,39660,2010,51016,33133,17883
310M100US39660,39660,2011,49819,34288,15531
310M100US39660,39660,2012,50646,33330,17316
310M200US39660,39660,2013,55969,38093,17876
310M200US39660,39660,2014,56274,37923,18351
310M200US39660,39660,2015,58598,42286,16312
310M300US39660,39660,2016,56614,39682,16932
3100000US39740,39740,2006,151380,110638,40742
3100000US39740,39740,2007,148639,112515,36124
3100000US39740,39740,2008,150091,109362,40729
3100000US39740,39740,2009,150942,111015,39927
310M100US39740,39740,2010,155329,110695,44634
310M100US39740,39740,2011,155425,112173,43252
310M100US39740,39740,2012,151291,106733,44558
310M200US39740,39740,2013,153271,112841,40430
310M200US39740,39740,2014,152908,107124,45784
310M200US39740,39740,2015,151792,108624,43168
310M300US39740,39740,2016,150402,107037,43365
3100000US39820,39820,2006,68385,44889,23496
3100000US39820,39820,2007,69474,44597,24877
3100000US39820,39820,2008,70067,45629,24438
3100000US39820,39820,2009,69738,44976,24762
310M100US39820,39820,2010,67909,44695,23214
310M100US39820,39820,2011,69102,45256,23846
310M100US39820,39820,2012,68165,42265,25900
310M200US39820,39820,2013,69729,42681,27048
310M200US39820,39820,2014,68542,42173,26369
310M200US39820,39820,2015,69799,42946,26853
310M300US39820,39820,2016,72095,47147,24948
3100000US39900,39900,2006,157618,96957,60661
3100000US39900,39900,2007,158395,96839,61556
3100000US39900,39900,2008,157204,94363,62841
3100000US39900,39900,2009,159496,97504,61992
310M100US39900,39900,2010,164809,95492,69317
310M100US39900,39900,2011,162548,94201,68347
310M100US39900,39900,2012,165964,95252,70712
310M200US39900,39900,2013,166432,93694,72738
310M200US39900,39900,2014,168863,97166,71697
310M200US39900,39900,2015,174571,97688,76883
310M300US39900,39900,2016,176627,101952,74675
3100000US39980,39980,2006,27476,19569,7907
3100000US39980,39980,2007,27947,19896,8051
3100000US39980,39980,2008,26872,18280,8592
3100000US39980,39980,2009,27958,18154,9804
310M100US39980,39980,2010,28374,18105,10269
310M100US39980,39980,2011,28274,19663,8611
310M100US39980,39980,2012,27849,18708,9141
310M200US39980,39980,2013,27425,18072,9353
310M200US39980,39980,2014,26937,18524,8413
310M200US39980,39980,2015,24238,16608,7630
310M300US39980,39980,2016,26538,17529,9009
3100000US40060,40060,2006,458695,319759,138936
3100000US40060,40060,2007,469044,322818,146226
3100000US40060,40060,2008,467002,328546,138456
3100000US40060,40060,2009,468076,322975,145101
310M100US40060,40060,2010,475685,327454,148231
310M100US40060,40060,2011,474191,317688,156503
310M100US40060,40060,2012,476759,320382,156377
310M200US40060,40060,2013,467399,299528,167871
310M200US40060,40060,2014,474003,306673,167330
310M200US40060,40060,2015,483127,309418,173709
310M300US40060,40060,2016,486877,317153,169724
3100000US40080,40080,2006,35081,23062,12019
3100000US40080,40080,2007,34665,22648,12017
3100000US40080,40080,2008,35928,22370,13558
3100000US40080,40080,2009,37110,23744,13366
310M100US40080,40080,2010,37878,23962,13916
310M100US40080,40080,2011,37723,23731,13992
310M100US40080,40080,2012,37098,23574,13524
310M200US40080,40080,2013,39116,24556,14560
310M200US40080,40080,2014,39682,23954,15728
310M200US40080,40080,2015,38730,23096,15634
310M300US40080,40080,2016,39499,25749,13750
3100000US40140,40140,2006,1235889,838093,397796
3100000US40140,40140,2007,1242312,839189,403123
3100000US40140,40140,2008,1227804,803472,424332
3100000US40140,40140,2009,1241712,817833,423879
310M100US40140,40140,2010,1265050,830808,434242
310M100US40140,40140,2011,1294496,832548,461948
310M100US40140,40140,2012,1285948,802224,483724
310M200US40140,40140,2013,1297675,803770,493905
310M200US40140,40140,2014,1317650,802313,515337
310M200US40140,40140,2015,1343526,817132,526394
310M300US40140,40140,2016,1348213,823457,524756
3100000US40220,40220,2006,122394,86129,36265
3100000US40220,40220,2007,127562,95155,32407
3100000US40220,40220,2008,127825,89024,38801
3100000US40220,40220,2009,124873,85653,39220
310M100US40220,40220,2010,129280,91743,37537
310M100US40220,40220,2011,124612,89348,35264
310M100US40220,40220,2012,129023,89698,39325
310M200US40220,40220,2013,128318,89101,39217
310M200US40220,40220,2014,129528,86767,42761
310M200US40220,40220,2015,127273,85685,41588
310M300US40220,40220,2016,127319,88055,39264
3100000US40260,40260,2006,29903,20174,9729
3100000US40260,40260,2007,28245,18134,10111
3100000US40260,40260,2008,28663,18860,9803
3100000US40260,40260,2009,29918,19418,10500
310M100US40260,40260,2010,29975,19982,9993
310M100US40260,40260,2011,31877,20715,11162
310M100US40260,40260,2012,29081,18601,10480
310M200US40260,40260,2013,29579,18886,10693
310M200US40260,40260,2014,28010,18506,9504
310M200US40260,40260,2015,28239,18179,10060
310M300US40260,40260,2016,30670,19352,11318
3100000US40340,40340,2006,70613,55881,14732
3100000US40340,40340,2007,71828,55905,15923
3100000US40340,40340,2008,71851,56450,15401
3100000US40340,40340,2009,72201,57386,14815
310M100US40340,40340,2010,72998,56949,16049
310M100US40340,40340,2011,73410,56779,16631
310M100US40340,40340,2012,73900,55732,18168
310M200US40340,40340,2013,82956,63445,19511
310M200US40340,40340,2014,83812,63237,20575
310M200US40340,40340,2015,83418,63242,20176
310M300US40340,40340,2016,85948,66089,19859
3100000US40380,40380,2006,397836,277096,120740
3100000US40380,40380,2007,399705,277492,122213
3100000US40380,40380,2008,398469,280451,118018
3100000US40380,40380,2009,405429,281933,123496
310M100US40380,40380,2010,414096,283738,130358
310M100US40380,40380,2011,418779,283566,135213
310M100US40380,40380,2012,419798,280399,139399
310M200US40380,40380,2013,425603,286410,139193
310M200US40380,40380,2014,428750,287151,141599
310M200US40380,40380,2015,427520,286955,140565
310M300US40380,40380,2016,430873,286363,144510
3100000US40420,40420,2006,125340,91773,33567
3100000US40420,40420,2007,129361,94596,34765
3100000US40420,40420,2008,127576,91858,35718
3100000US40420,40420,2009,132323,90615,41708
310M100US40420,40420,2010,129937,91943,37994
310M100US40420,40420,2011,129301,90228,39073
310M100US40420,40420,2012,130401,88636,41765
310M200US40420,40420,2013,131292,90241,41051
310M200US40420,40420,2014,133136,87388,45748
310M200US40420,40420,2015,132190,89576,42614
310M300US40420,40420,2016,133670,86176,47494
3100000US40580,40580,2006,56322,34736,21586
3100000US40580,40580,2007,58577,36932,21645
3100000US40580,40580,2008,59421,38026,21395
3100000US40580,40580,2009,60465,37419,23046
310M100US40580,40580,2010,59832,38272,21560
310M100US40580,40580,2011,57369,35930,21439
310M100US40580,40580,2012,55868,36189,19679
310M200US40580,40580,2013,58462,36612,21850
310M200US40580,40580,2014,58714,37162,21552
310M200US40580,40580,2015,57450,34851,22599
310M300US40580,40580,2016,56153,34407,21746
3100000US40660,40660,2006,34763,23318,11445
3100000US40660,40660,2007,33472,24025,9447
3100000US40660,40660,2008,35247,23117,12130
3100000US40660,40660,2009,34566,23243,11323
310M100US40660,40660,2010,35634,22925,12709
310M100US40660,40660,2011,34919,22457,12462
310M100US40660,40660,2012,34373,22636,11737
310M200US40660,40660,2013,33099,18579,14520
310M200US40660,40660,2014,36177,20432,15745
310M200US40660,40660,2015,34931,20154,14777
310M300US40660,40660,2016,35411,21498,13913
3100000US40700,40700,2006,42554,29948,12606
3100000US40700,40700,2007,41824,29196,12628
3100000US40700,40700,2008,40993,27771,13222
3100000US40700,40700,2009,42259,30163,12096
310M100US40700,40700,2010,44191,31316,12875
310M100US40700,40700,2011,43401,29926,13475
310M100US40700,40700,2012,43348,29562,13786
310M200US40700,40700,2013,43389,28820,14569
310M200US40700,40700,2014,43290,29993,13297
310M200US40700,40700,2015,44046,28694,15352
310M300US40700,40700,2016,43818,29708,14110
3100000US40740,40740,2008,23568,14937,8631
3100000US40740,40740,2009,22276,16133,6143
310M100US40740,40740,2010,23859,16104,7755
310M100US40740,40740,2011,23447,16380,7067
310M100US40740,40740,2012,22944,14617,8327
310M200US40740,40740,2013,23806,15530,8276
310M200US40740,40740,2014,23747,14969,8778
310M200US40740,40740,2015,22665,15942,6723
310M300US40740,40740,2016,22516,15149,7367
3100000US40780,40780,2006,29320,21082,8238
3100000US40780,40780,2007,30255,20981,9274
3100000US40780,40780,2008,30360,21621,8739
3100000US40780,40780,2009,29026,19909,9117
310M100US40780,40780,2010,29950,21974,7976
310M100US40780,40780,2011,31478,21563,9915
310M100US40780,40780,2012,29533,20623,8910
310M200US40780,40780,2013,31676,21165,10511
310M200US40780,40780,2014,30488,20748,9740
310M200US40780,40780,2015,30171,19374,10797
310M300US40780,40780,2016,30654,21024,9630
3100000US40900,40900,2006,753246,480881,272365
3100000US40900,40900,2007,766216,484148,282068
3100000US40900,40900,2008,764628,475063,289565
3100000US40900,40900,2009,766713,472308,294405
310M100US40900,40900,2010,781425,476733,304692
310M100US40900,40900,2011,782019,467562,314457
310M100US40900,40900,2012,786864,465098,321766
310M200US40900,40900,2013,792639,458162,334477
310M200US40900,40900,2014,797624,467443,330181
310M200US40900,40900,2015,809295,474156,335139
310M300US40900,40900,2016,816902,482989,333913
3100000US40980,40980,2006,77391,58710,18681
3100000US40980,40980,2007,76003,56682,19321
3100000US40980,40980,2008,78521,57327,21194
3100000US40980,40980,2009,78862,58218,20644
310M100US40980,40980,2010,75609,55781,19828
310M100US40980,40980,2011,76342,54407,21935
310M100US40980,40980,2012,78010,57017,20993
310M200US40980,40980,2013,77518,55187,22331
310M200US40980,40980,2014,78000,57738,20262
310M200US40980,40980,2015,77211,54489,22722
310M300US40980,40980,2016,78494,56476,22018
3100000US41060,41060,2006,70059,51278,18781
3100000US41060,41060,2007,69834,51017,18817
3100000US41060,41060,2008,70908,52778,18130
3100000US41060,41060,2009,72178,52000,20178
310M100US41060,41060,2010,71145,51430,19715
310M100US41060,41060,2011,72032,51630,20402
310M100US41060,41060,2012,71971,51735,20236
310M200US41060,41060,2013,72873,50393,22480
310M200US41060,41060,2014,72884,51623,21261
310M200US41060,41060,2015,74617,48773,25844
310M300US41060,41060,2016,74834,51248,23586
3100000US41100,41100,2006,43972,31660,12312
3100000US41100,41100,2007,44814,32370,12444
3100000US41100,41100,2008,46210,32141,14069
3100000US41100,41100,2009,45603,32085,13518
310M100US41100,41100,2010,47413,32513,14900
310M100US41100,41100,2011,46216,32155,14061
310M100US41100,41100,2012,48186,32841,15345
310M200US41100,41100,2013,49394,35164,14230
310M200US41100,41100,2014,49468,33987,15481
310M200US41100,41100,2015,52453,34818,17635
310M300US41100,41100,2016,51774,38299,13475
3100000US41140,41140,2006,46227,32840,13387
3100000US41140,41140,2007,47619,32901,14718
3100000US41140,41140,2008,46054,31883,14171
3100000US41140,41140,2009,44943,31300,13643
310M100US41140,41140,2010,48133,32447,15686
310M100US41140,41140,2011,46101,31384,14717
310M100US41140,41140,2012,47656,30841,16815
310M200US41140,41140,2013,46237,29715,16522
310M200US41140,41140,2014,46526,31071,15455
310M200US41140,41140,2015,46518,31512,15006
310M300US41140,41140,2016,48068,31332,16736
3100000US41180,41180,2006,1095451,800702,294749
3100000US41180,41180,2007,1094448,802490,291958
3100000US41180,41180,2008,1109251,803941,305310
3100000US41180,41180,2009,1111547,785781,325766
310M100US41180,41180,2010,1112442,784138,328304
310M100US41180,41180,2011,1105266,778562,326704
310M100US41180,41180,2012,1108723,772434,336289
310M200US41180,41180,2013,1105652,769289,336363
310M200US41180,41180,2014,1096200,752867,343333
310M200US41180,41180,2015,1108303,756824,351479
310M300US41180,41180,2016,1113234,760308,352926
310M200US41400,41400,2013,40274,29382,10892
310M200US41400,41400,2014,42107,29990,12117
310M200US41400,41400,2015,42116,29519,12597
310M300US41400,41400,2016,41469,30823,10646
3100000US41420,41420,2006,135614,89654,45960
3100000US41420,41420,2007,138677,87263,51414
3100000US41420,41420,2008,138343,88214,50129
3100000US41420,41420,2009,137767,86761,51006
310M100US41420,41420,2010,143114,89531,53583
310M100US41420,41420,2011,139316,82516,56800
310M100US41420,41420,2012,142746,89220,53526
310M200US41420,41420,2013,142174,84549,57625
310M200US41420,41420,2014,141971,85731,56240
310M200US41420,41420,2015,144600,86925,57675
310M300US41420,41420,2016,146078,88125,57953
3100000US41500,41500,2006,123600,68716,54884
3100000US41500,41500,2007,126010,64807,61203
3100000US41500,41500,2008,126066,65439,60627
3100000US41500,41500,2009,128025,64565,63460
310M100US41500,41500,2010,125446,63894,61552
310M100US41500,41500,2011,123757,58668,65089
310M100US41500,41500,2012,124171,60584,63587
310M200US41500,41500,2013,125553,61919,63634
310M200US41500,41500,2014,123920,63113,60807
310M200US41500,41500,2015,126904,62257,64647
310M300US41500,41500,2016,125740,61838,63902
3100000US41540,41540,2006,42743,29153,13590
3100000US41540,41540,2007,44887,28760,16127
3100000US41540,41540,2008,45521,29526,15995
3100000US41540,41540,2009,44666,28690,15976
310M100US41540,41540,2010,43998,28110,15888
310M100US41540,41540,2011,44556,29669,14887
310M100US41540,41540,2012,44623,28712,15911
310M200US41540,41540,2013,143465,103400,40065
310M200US41540,41540,2014,151227,109845,41382
310M200US41540,41540,2015,154242,110184,44058
310M300US41540,41540,2016,149074,108923,40151
3100000US41580,41580,2006,51268,36629,14639
3100000US41580,41580,2007,52947,40525,12422
3100000US41580,41580,2008,52547,36085,16462
3100000US41580,41580,2009,53870,38208,15662
310M100US41580,41580,2010,53585,37062,16523
310M100US41580,41580,2011,52767,36061,16706
310M100US41580,41580,2012,51406,35161,16245
3100000US41620,41620,2006,351280,249396,101884
3100000US41620,41620,2007,359981,248111,111870
3100000US41620,41620,2008,364078,253160,110918
3100000US41620,41620,2009,369005,256113,112892
310M100US41620,41620,2010,369754,253208,116546
310M100US41620,41620,2011,375903,250917,124986
310M100US41620,41620,2012,380362,254754,125608
310M200US41620,41620,2013,366765,244038,122727
310M200US41620,41620,2014,376913,250051,126862
310M200US41620,41620,2015,377058,249644,127414
310M300US41620,41620,2016,386481,258449,128032
3100000US41660,41660,2006,42121,28008,14113
3100000US41660,41660,2007,41154,29376,11778
3100000US41660,41660,2008,41315,27033,14282
3100000US41660,41660,2009,42942,28555,14387
310M100US41660,41660,2010,42192,28437,13755
310M100US41660,41660,2011,42426,26750,15676
310M100US41660,41660,2012,43104,25380,17724
310M200US41660,41660,2013,44059,28046,16013
310M200US41660,41660,2014,43143,26279,16864
310M200US41660,41660,2015,45137,27401,17736
310M300US41660,41660,2016,44044,26964,17080
3100000US41700,41700,2006,663074,442700,220374
3100000US41700,41700,2007,679614,444213,235401
3100000US41700,41700,2008,689432,453751,235681
3100000US41700,41700,2009,690063,448642,241421
310M100US41700,41700,2010,749906,475760,274146
310M100US41700,41700,2011,763204,480563,282641
310M100US41700,41700,2012,766963,478614,288349
310M200US41700,41700,2013,778939,478111,300828
310M200US41700,41700,2014,786460,482770,303690
310M200US41700,41700,2015,791273,481236,310037
310M300US41700,41700,2016,796140,492304,303836
3100000US41740,41740,2006,1039619,599242,440377
3100000US41740,41740,2007,1045265,584243,461022
3100000US41740,41740,2008,1037958,585307,452651
3100000US41740,41740,2009,1048975,578787,470188
310M100US41740,41740,2010,1061210,572400,488810
310M100US41740,41740,2011,1061056,565447,495609
310M100US41740,41740,2012,1079653,573530,506123
310M200US41740,41740,2013,1093386,576985,516401
310M200US41740,41740,2014,1100858,574323,526535
310M200US41740,41740,2015,1113610,579465,534145
310M300US41740,41740,2016,1110568,578303,532265
3100000US41780,41780,2006,31507,22873,8634
3100000US41780,41780,2007,31889,24649,7240
3100000US41780,41780,2008,31132,22840,8292
3100000US41780,41780,2009,30861,22172,8689
310M100US41780,41780,2010,32243,22290,9953
310M100US41780,41780,2011,31148,21158,9990
310M100US41780,41780,2012,31739,21872,9867
310M200US41780,41780,2013,33168,23010,10158
310M200US41780,41780,2014,31492,21060,10432
310M200US41780,41780,2015,30876,21227,9649
310M300US41780,41780,2016,30682,21808,8874
3100000US41860,41860,2006,1551115,906476,644639
3100000US41860,41860,2007,1559168,901482,657686
3100000US41860,41860,2008,1566000,890946,675054
3100000US41860,41860,2009,1559650,866198,693452
310M100US41860,41860,2010,1601506,871721,729785
310M100US41860,41860,2011,1622840,870876,751964
310M100US41860,41860,2012,1636828,867828,769000
310M200US41860,41860,2013,1654554,886449,768105
310M200US41860,41860,2014,1665925,886304,779621
310M200US41860,41860,2015,1689907,903500,786407
310M300US41860,41860,2016,1691781,906858,784923
3100000US41900,41900,2006,49159,38332,10827
3100000US41900,41900,2007,45578,34106,11472
3100000US41900,41900,2008,44657,34070,10587
3100000US41900,41900,2009,41211,31383,9828
310M100US41900,41900,2010,43287,31090,12197
310M100US41900,41900,2011,43016,28288,14728
310M100US41900,41900,2012,45276,29287,15989
310M200US41900,41900,2013,46143,29976,16167
310M200US41900,41900,2014,46975,30052,16923
310M200US41900,41900,2015,43954,27331,16623
310M300US41900,41900,2016,43167,29144,14023
3100000US41940,41940,2006,601239,365780,235459
3100000US41940,41940,2007,598199,364526,233673
3100000US41940,41940,2008,604720,366099,238621
3100000US41940,41940,2009,603865,355557,248308
310M100US41940,41940,2010,616837,353431,263406
310M100US41940,41940,2011,622532,354510,268022
310M100US41940,41940,2012,630849,355685,275164
310M200US41940,41940,2013,636628,356372,280256
310M200US41940,41940,2014,639301,359965,279336
310M200US41940,41940,2015,651352,366317,285035
310M300US41940,41940,2016,653296,369737,283559
3100000US41980,41980,2006,828207,612511,215696
3100000US41980,41980,2007,802715,599463,203252
3100000US41980,41980,2008,795254,579780,215474
3100000US41980,41980,2009,791409,562958,228451
310M100US41980,41980,2010,888077,624565,263512
310M100US41980,41980,2011,841104,586514,254590
310M100US41980,41980,2012,855555,592472,263083
310M200US41980,41980,2013,797979,552540,245439
310M200US41980,41980,2014,789015,539393,249622
310M200US41980,41980,2015,782561,540056,242505
310M300US41980,41980,2016,770603,522470,248133
3100000US42020,42020,2006,102007,60654,41353
3100000US42020,42020,2007,104382,59915,44467
3100000US42020,42020,2008,100901,63686,37215
3100000US42020,42020,2009,103011,63780,39231
310M100US42020,42020,2010,99653,59862,39791
310M100US42020,42020,2011,101179,56773,44406
310M100US42020,42020,2012,101897,56105,45792
310M200US42020,42020,2013,104669,59488,45181
310M200US42020,42020,2014,102645,61202,41443
310M200US42020,42020,2015,104760,61742,43018
310M300US42020,42020,2016,106312,66537,39775
3100000US42060,42060,2006,140752,75011,65741
3100000US42060,42060,2007,142465,76420,66045
3100000US42060,42060,2008,139212,75128,64084
3100000US42060,42060,2009,140128,74286,65842
310M100US42060,42060,2010,140842,75146,65696
310M100US42060,42060,2011,140889,71387,69502
310M100US42060,42060,2012,141639,73176,68463
3100000US42100,42100,2006,92998,55666,37332
3100000US42100,42100,2007,93690,55748,37942
3100000US42100,42100,2008,93759,55999,37760
3100000US42100,42100,2009,92227,56015,36212
310M100US42100,42100,2010,91264,54209,37055
310M100US42100,42100,2011,94775,54319,40456
310M100US42100,42100,2012,93253,52900,40353
310M200US42100,42100,2013,93982,56426,37556
310M200US42100,42100,2014,96127,54393,41734
310M200US42100,42100,2015,93317,51705,41612
310M300US42100,42100,2016,96257,56232,40025
3100000US42140,42140,2006,53277,38641,14636
3100000US42140,42140,2007,53358,37856,15502
3100000US42140,42140,2008,55090,39908,15182
3100000US42140,42140,2009,54826,38302,16524
310M100US42140,42140,2010,61494,42279,19215
310M100US42140,42140,2011,60935,40028,20907
310M100US42140,42140,2012,62311,42035,20276
310M200US42140,42140,2013,60405,42819,17586
310M200US42140,42140,2014,60565,41273,19292
310M200US42140,42140,2015,60642,42530,18112
310M300US42140,42140,2016,60096,41983,18113
310M200US42200,42200,2013,140665,73083,67582
310M200US42200,42200,2014,142912,74653,68259
310M200US42200,42200,2015,144261,73953,70308
310M300US42200,42200,2016,142449,72634,69815
3100000US42220,42220,2006,178483,114133,64350
3100000US42220,42220,2007,178505,110167,68338
3100000US42220,42220,2008,181159,115000,66159
3100000US42220,42220,2009,180378,109437,70941
310M100US42220,42220,2010,185711,110953,74758
310M100US42220,42220,2011,180703,107486,73217
310M100US42220,42220,2012,184348,110476,73872
310M200US42220,42220,2013,189087,110682,78405
310M200US42220,42220,2014,190875,111446,79429
310M200US42220,42220,2015,190662,113432,77230
310M300US42220,42220,2016,187504,114629,72875
3100000US42260,42260,2006,307668,232647,75021
3100000US42260,42260,2007,296886,226544,70342
3100000US42340,42340,2006,124109,76016,48093
3100000US42340,42340,2007,126311,80441,45870
3100000US42340,42340,2008,127807,76886,50921
3100000US42340,42340,2009,127926,80643,47283
310M100US42340,42340,2010,130517,79750,50767
310M100US42340,42340,2011,129708,78707,51001
310M100US42340,42340,2012,132868,79764,53104
310M200US42340,42340,2013,132260,77371,54889
310M200US42340,42340,2014,135708,79916,55792
310M200US42340,42340,2015,138784,76514,62270
310M300US42340,42340,2016,143081,83608,59473
3100000US42540,42540,2006,226177,157699,68478
3100000US42540,42540,2007,227021,155896,71125
3100000US42540,42540,2008,229234,155352,73882
3100000US42540,42540,2009,232193,158027,74166
310M100US42540,42540,2010,225165,152751,72414
310M100US42540,42540,2011,227044,152571,74473
310M100US42540,42540,2012,225527,147844,77683
310M200US42540,42540,2013,223354,151882,71472
310M200US42540,42540,2014,220225,150731,69494
310M200US42540,42540,2015,221200,149212,71988
310M300US42540,42540,2016,220572,147260,73312
3100000US42580,42580,2006,73397,59422,13975
3100000US42580,42580,2007,74715,57428,17287
3100000US42580,42580,2008,74546,57092,17454
3100000US42580,42580,2009,73007,59092,13915
310M100US42580,42580,2010,74029,59304,14725
310M100US42580,42580,2011,74205,59379,14826
310M100US42580,42580,2012,77995,60055,17940
3100000US42620,42620,2006,27454,19691,7763
3100000US42620,42620,2007,26721,17989,8732
3100000US42620,42620,2008,28079,20430,7649
3100000US42620,42620,2009,28750,19254,9496
310M100US42620,42620,2010,29806,19645,10161
310M100US42620,42620,2011,30359,20403,9956
310M100US42620,42620,2012,29089,20792,8297
310M200US42620,42620,2013,29038,20381,8657
310M200US42620,42620,2014,29146,19812,9334
310M200US42620,42620,2015,28895,18450,10445
310M300US42620,42620,2016,28221,17640,10581
3100000US42660,42660,2006,1293236,819357,473879
3100000US42660,42660,2007,1309665,842396,467269
3100000US42660,42660,2008,1341688,851384,490304
3100000US42660,42660,2009,1345187,830952,514235
310M100US42660,42660,2010,1353765,820666,533099
310M100US42660,42660,2011,1364274,817886,546388
310M100US42660,42660,2012,1375184,818600,556584
310M200US42660,42660,2013,1392337,823321,569016
310M200US42660,42660,2014,1406259,833924,572335
310M200US42660,42660,2015,1437222,861541,575681
310M300US42660,42660,2016,1464941,871443,593498
3100000US42680,42680,2006,59550,44239,15311
3100000US42680,42680,2007,57334,43443,13891
3100000US42680,42680,2008,60427,45003,15424
3100000US42680,42680,2009,61398,45253,16145
310M100US42680,42680,2010,53151,40013,13138
310M100US42680,42680,2011,57515,43810,13705
310M100US42680,42680,2012,58950,43984,14966
310M200US42680,42680,2013,57435,41217,16218
310M200US42680,42680,2014,55618,40644,14974
310M200US42680,42680,2015,55494,42755,12739
310M300US42680,42680,2016,55427,43141,12286
3100000US42700,42700,2006,40989,33186,7803
3100000US42700,42700,2007,41295,31648,9647
3100000US42700,42700,2008,38894,30058,8836
3100000US42700,42700,2009,39062,32092,6970
310M100US42700,42700,2010,39675,30618,9057
310M100US42700,42700,2011,40123,31982,8141
310M100US42700,42700,2012,39112,29697,9415
310M200US42700,42700,2013,40368,30646,9722
310M200US42700,42700,2014,39288,29995,9293
310M200US42700,42700,2015,41116,30814,10302
310M300US42700,42700,2016,38808,28468,10340
3100000US42860,42860,2006,28087,22222,5865
3100000US42860,42860,2007,29267,21548,7719
3100000US42860,42860,2008,31240,23319,7921
3100000US42860,42860,2009,30958,22836,8122
310M100US42860,42860,2010,29783,22500,7283
310M100US42860,42860,2011,29728,22468,7260
310M100US42860,42860,2012,30688,21678,9010
310M200US42860,42860,2013,29866,22434,7432
310M200US42860,42860,2014,32113,23274,8839
310M200US42860,42860,2015,31488,22618,8870
310M300US42860,42860,2016,31498,22319,9179
3100000US42940,42940,2006,30893,22099,8794
3100000US42940,42940,2007,31247,23059,8188
3100000US42940,42940,2008,31220,22142,9078
3100000US42940,42940,2009,31027,21569,9458
310M100US42940,42940,2010,36141,24607,11534
310M100US42940,42940,2011,35873,23494,12379
310M100US42940,42940,2012,36334,24889,11445
310M200US42940,42940,2013,36836,24435,12401
310M200US42940,42940,2014,35072,22870,12202
310M200US42940,42940,2015,37846,24324,13522
310M300US42940,42940,2016,36098,25161,10937
3100000US43060,43060,2006,24352,17897,6455
3100000US43060,43060,2007,25397,18358,7039
3100000US43060,43060,2008,24578,16733,7845
3100000US43060,43060,2009,24470,18306,6164
310M100US43060,43060,2010,26086,19337,6749
310M100US43060,43060,2011,25663,18901,6762
310M100US43060,43060,2012,26333,18052,8281
310M200US43060,43060,2013,25894,17853,8041
310M200US43060,43060,2014,25733,16802,8931
310M200US43060,43060,2015,26111,18263,7848
310M300US43060,43060,2016,25547,17744,7803
3100000US43100,43100,2006,46575,32906,13669
3100000US43100,43100,2007,46763,33450,13313
3100000US43100,43100,2008,46191,33734,12457
3100000US43100,43100,2009,45804,33757,12047
310M100US43100,43100,2010,46153,33285,12868
310M100US43100,43100,2011,45977,32770,13207
310M100US43100,43100,2012,46653,32777,13876
310M200US43100,43100,2013,47295,33579,13716
310M200US43100,43100,2014,46504,32925,13579
310M200US43100,43100,2015,47438,33060,14378
310M300US43100,43100,2016,47652,33022,14630
3100000US43140,43140,2006,36260,27043,9217
3100000US43140,43140,2007,36611,25601,11010
3100000US43140,43140,2008,38503,24858,13645
3100000US43140,43140,2009,38804,25966,12838
310M100US43140,43140,2010,37208,25396,11812
310M100US43140,43140,2011,36513,24086,12427
310M100US43140,43140,2012,36818,25023,11795
310M200US43140,43140,2013,38409,26290,12119
310M200US43140,43140,2014,37038,25193,11845
310M200US43140,43140,2015,36291,24404,11887
310M300US43140,43140,2016,36405,23315,13090
3100000US43300,43300,2006,45202,32658,12544
3100000US43300,43300,2007,43556,29976,13580
3100000US43300,43300,2008,44588,32468,12120
3100000US43300,43300,2009,46019,30537,15482
310M100US43300,43300,2010,44885,30447,14438
310M100US43300,43300,2011,46447,30458,15989
310M100US43300,43300,2012,47770,33065,14705
310M200US43300,43300,2013,46311,29546,16765
310M200US43300,43300,2014,46621,31504,15117
310M200US43300,43300,2015,47538,32387,15151
310M300US43300,43300,2016,47135,31842,15293
3100000US43320,43320,2008,36400,26024,10376
3100000US43320,43320,2009,35112,25299,9813
310M100US43320,43320,2010,34891,25760,9131
310M100US43320,43320,2011,33305,23437,9868
310M100US43320,43320,2012,35488,24620,10868
310M200US43320,43320,2013,34147,23649,10498
310M200US43320,43320,2014,33236,23235,10001
310M200US43320,43320,2015,33772,23414,10358
310M300US43320,43320,2016,33587,23358,10229
3100000US43340,43340,2006,147352,98071,49281
3100000US43340,43340,2007,151642,96053,55589
3100000US43340,43340,2008,148779,94996,53783
3100000US43340,43340,2009,154991,101024,53967
310M100US43340,43340,2010,154252,97593,56659
310M100US43340,43340,2011,154371,99680,54691
310M100US43340,43340,2012,153275,95553,57722
310M200US43340,43340,2013,169481,108626,60855
310M200US43340,43340,2014,167018,103166,63852
310M200US43340,43340,2015,171531,105354,66177
310M300US43340,43340,2016,170899,104126,66773
3100000US43420,43420,2006,48718,34226,14492
3100000US43420,43420,2007,48054,33552,14502
3100000US43420,43420,2008,47692,32859,14833
3100000US43420,43420,2009,48839,34300,14539
310M100US43420,43420,2010,49834,33663,16171
310M100US43420,43420,2011,47402,33151,14251
310M100US43420,43420,2012,49983,33070,16913
310M200US43420,43420,2013,48368,34059,14309
310M200US43420,43420,2014,47653,31958,15695
310M200US43420,43420,2015,50202,33958,16244
310M300US43420,43420,2016,50147,33179,16968
3100000US43580,43580,2006,54963,39397,15566
3100000US43580,43580,2007,53866,37280,16586
3100000US43580,43580,2008,54831,37501,17330
3100000US43580,43580,2009,54811,36227,18584
310M100US43580,43580,2010,54012,36555,17457
310M100US43580,43580,2011,54922,36619,18303
310M100US43580,43580,2012,53573,36346,17227
310M200US43580,43580,2013,63754,45294,18460
310M200US43580,43580,2014,64369,44262,20107
310M200US43580,43580,2015,63198,43320,19878
310M300US43580,43580,2016,64589,44838,19751
3100000US43620,43620,2006,83708,58366,25342
3100000US43620,43620,2007,85405,58569,26836
3100000US43620,43620,2008,88273,61213,27060
3100000US43620,43620,2009,86409,59368,27041
310M100US43620,43620,2010,89664,60124,29540
310M100US43620,43620,2011,90887,61552,29335
310M100US43620,43620,2012,90466,58482,31984
310M200US43620,43620,2013,94244,64129,30115
310M200US43620,43620,2014,94764,63646,31118
310M200US43620,43620,2015,98273,66476,31797
310M300US43620,43620,2016,98176,65932,32244
3100000US43740,43740,2006,30332,23534,6798
3100000US43740,43740,2007,30593,23804,6789
3100000US43740,43740,2008,30615,24264,6351
3100000US43740,43740,2009,29960,24024,5936
310M100US43740,43740,2010,29592,21836,7756
310M100US43740,43740,2011,28898,23059,5839
310M100US43740,43740,2012,30048,23988,6060
310M200US43740,43740,2013,30066,23216,6850
310M200US43740,43740,2014,29481,23627,5854
310M200US43740,43740,2015,29199,22740,6459
310M300US43740,43740,2016,29189,22559,6630
3100000US43780,43780,2006,120393,89430,30963
3100000US43780,43780,2007,120627,87871,32756
3100000US43780,43780,2008,119313,87171,32142
3100000US43780,43780,2009,122038,90278,31760
310M100US43780,43780,2010,119517,84877,34640
310M100US43780,43780,2011,121910,87193,34717
310M100US43780,43780,2012,121241,87200,34041
310M200US43780,43780,2013,123138,84812,38326
310M200US43780,43780,2014,121857,84299,37558
310M200US43780,43780,2015,119494,84865,34629
310M300US43780,43780,2016,117259,80370,36889
3100000US43860,43860,2006,31154,23823,7331
3100000US43860,43860,2007,26315,21214,5101
3100000US43860,43860,2008,31743,23908,7835
3100000US43860,43860,2009,36931,26570,10361
310M100US43860,43860,2010,37834,27893,9941
310M100US43860,43860,2011,35673,27056,8617
310M100US43860,43860,2012,37060,28133,8927
3100000US43900,43900,2006,107254,77239,30015
3100000US43900,43900,2007,104485,77449,27036
3100000US43900,43900,2008,106848,72502,34346
3100000US43900,43900,2009,106692,76920,29772
310M100US43900,43900,2010,105598,74427,31171
310M100US43900,43900,2011,105420,72672,32748
310M100US43900,43900,2012,108569,73545,35024
310M200US43900,43900,2013,119827,81345,38482
310M200US43900,43900,2014,121860,81273,40587
310M200US43900,43900,2015,124570,85497,39073
310M300US43900,43900,2016,125096,86666,38430
3100000US44060,44060,2006,178958,118155,60803
3100000US44060,44060,2007,180645,118941,61704
3100000US44060,44060,2008,184672,119071,65601
3100000US44060,44060,2009,185827,120711,65116
310M100US44060,44060,2010,187672,118781,68891
310M100US44060,44060,2011,187360,120608,66752
310M100US44060,44060,2012,189004,119019,69985
310M200US44060,44060,2013,208513,132011,76502
310M200US44060,44060,2014,209867,132961,76906
310M200US44060,44060,2015,215652,133806,81846
310M300US44060,44060,2016,217598,139740,77858
3100000US44100,44100,2006,86276,61153,25123
3100000US44100,44100,2007,87911,62483,25428
3100000US44100,44100,2008,86405,64785,21620
3100000US44100,44100,2009,88253,61974,26279
310M100US44100,44100,2010,88364,61387,26977
310M100US44100,44100,2011,87671,62129,25542
310M100US44100,44100,2012,87490,62171,25319
310M200US44100,44100,2013,87918,61524,26394
310M200US44100,44100,2014,88468,60393,28075
310M200US44100,44100,2015,88081,60153,27928
310M300US44100,44100,2016,87484,61735,25749
3100000US44140,44140,2006,258921,169654,89267
3100000US44140,44140,2007,260619,168121,92498
3100000US44140,44140,2008,262916,173419,89497
3100000US44140,44140,2009,267069,170845,96224
310M100US44140,44140,2010,270260,170970,99290
310M100US44140,44140,2011,265490,168871,96619
310M100US44140,44140,2012,263453,168945,94508
310M200US44140,44140,2013,234947,147263,87684
310M200US44140,44140,2014,235074,141243,93831
310M200US44140,44140,2015,233619,145984,87635
310M300US44140,44140,2016,236790,149053,87737
3100000US44180,44180,2006,165143,110724,54419
3100000US44180,44180,2007,168158,115136,53022
3100000US44180,44180,2008,171666,113908,57758
3100000US44180,44180,2009,172091,109368,62723
310M100US44180,44180,2010,173946,113855,60091
310M100US44180,44180,2011,173517,110007,63510
310M100US44180,44180,2012,176987,112374,64613
310M200US44180,44180,2013,179138,111498,67640
310M200US44180,44180,2014,179069,113184,65885
310M200US44180,44180,2015,179752,110427,69325
310M300US44180,44180,2016,181989,111912,70077
3100000US44220,44220,2006,56292,38911,17381
3100000US44220,44220,2007,54093,39459,14634
3100000US44220,44220,2008,54606,38982,15624
3100000US44220,44220,2009,55848,38517,17331
310M100US44220,44220,2010,55459,35821,19638
310M100US44220,44220,2011,54573,37104,17469
310M100US44220,44220,2012,54288,35114,19174
310M200US44220,44220,2013,54372,37017,17355
310M200US44220,44220,2014,55199,35284,19915
310M200US44220,44220,2015,54232,35524,18708
310M300US44220,44220,2016,54548,34859,19689
3100000US44300,44300,2006,50014,29888,20126
3100000US44300,44300,2007,52515,32919,19596
3100000US44300,44300,2008,51205,31764,19441
3100000US44300,44300,2009,53246,30210,23036
310M100US44300,44300,2010,56358,33057,23301
310M100US44300,44300,2011,58695,34712,23983
310M100US44300,44300,2012,56980,34479,22501
310M200US44300,44300,2013,56729,35118,21611
310M200US44300,44300,2014,57583,34440,23143
310M200US44300,44300,2015,56116,33154,22962
310M300US44300,44300,2016,57410,36884,20526
3100000US44340,44340,2007,24525,14451,10074
3100000US44340,44340,2008,24036,14772,9264
3100000US44340,44340,2009,24172,12852,11320
310M100US44340,44340,2010,25215,13431,11784
310M100US44340,44340,2011,25535,12696,12839
310M100US44340,44340,2012,26718,12902,13816
310M200US44340,44340,2013,25010,12337,12673
310M200US44340,44340,2014,25844,13130,12714
310M200US44340,44340,2015,26495,13563,12932
310M300US44340,44340,2016,26411,14951,11460
3100000US44380,44380,2006,55684,41457,14227
3100000US44380,44380,2007,57295,43268,14027
3100000US44380,44380,2008,61243,44133,17110
3100000US44380,44380,2009,60643,44975,15668
310M100US44380,44380,2010,58813,42554,16259
310M100US44380,44380,2011,59952,45073,14879
310M100US44380,44380,2012,58660,42835,15825
3100000US44420,44420,2006,45514,32773,12741
3100000US44420,44420,2007,46651,33131,13520
3100000US44420,44420,2008,48776,35618,13158
3100000US44420,44420,2009,46847,34725,12122
310M100US44420,44420,2010,45218,32971,12247
310M100US44420,44420,2011,47364,34047,13317
310M100US44420,44420,2012,48860,34889,13971
310M200US44420,44420,2013,46086,32086,14000
310M200US44420,44420,2014,48754,34638,14116
310M200US44420,44420,2015,46768,30694,16074
310M300US44420,44420,2016,50508,35266,15242
310M100US44600,44600,2010,52107,40072,12035
310M100US44600,44600,2011,49844,37770,12074
310M100US44600,44600,2012,50663,35956,14707
3100000US44620,44620,2006,26498,19646,6852
3100000US44620,44620,2007,26903,19059,7844
3100000US44620,44620,2008,27681,18873,8808
3100000US44620,44620,2009,27120,18712,8408
310M100US44620,44620,2010,28920,19585,9335
310M100US44620,44620,2011,27479,18636,8843
310M100US44620,44620,2012,28270,19465,8805
310M200US44620,44620,2013,27605,19036,8569
310M200US44620,44620,2014,27360,18323,9037
310M200US44620,44620,2015,27856,19355,8501
310M300US44620,44620,2016,28009,19125,8884
3100000US44660,44660,2006,25330,15940,9390
3100000US44660,44660,2007,29146,15776,13370
3100000US44660,44660,2008,28675,16651,12024
3100000US44660,44660,2009,30000,16265,13735
310M100US44660,44660,2010,30344,15220,15124
310M100US44660,44660,2011,30929,16186,14743
310M100US44660,44660,2012,29867,15519,14348
310M200US44660,44660,2013,30026,13962,16064
310M200US44660,44660,2014,29934,15143,14791
310M200US44660,44660,2015,30876,14908,15968
310M300US44660,44660,2016,30657,15163,15494
3100000US44700,44700,2006,210462,132481,77981
3100000US44700,44700,2007,207370,131039,76331
3100000US44700,44700,2008,205056,121162,83894
3100000US44700,44700,2009,208513,126980,81533
310M100US44700,44700,2010,215469,124244,91225
310M100US44700,44700,2011,213749,124893,88856
310M100US44700,44700,2012,215761,121799,93962
310M200US44700,44700,2013,216309,119716,96593
310M200US44700,44700,2014,221874,118695,103179
310M200US44700,44700,2015,223062,122644,100418
310M300US44700,44700,2016,227186,122916,104270
3100000US44940,44940,2006,39030,26830,12200
3100000US44940,44940,2007,39445,26042,13403
3100000US44940,44940,2008,39631,28308,11323
3100000US44940,44940,2009,37767,26832,10935
310M100US44940,44940,2010,38363,24226,14137
310M100US44940,44940,2011,41041,26300,14741
310M100US44940,44940,2012,40321,25780,14541
310M200US44940,44940,2013,39739,25790,13949
310M200US44940,44940,2014,39936,26627,13309
310M200US44940,44940,2015,41017,26219,14798
310M300US44940,44940,2016,41439,27078,14361
3100000US44980,44980,2006,38014,28838,9176
3100000US44980,44980,2007,37998,27037,10961
3100000US44980,44980,2008,38267,27414,10853
3100000US44980,44980,2009,38291,26816,11475
310M100US44980,44980,2010,38424,27740,10684
310M100US44980,44980,2011,39378,28144,11234
310M100US44980,44980,2012,39070,27256,11814
310M200US44980,44980,2013,39428,28457,10971
310M200US44980,44980,2014,38712,27502,11210
310M200US44980,44980,2015,39981,28567,11414
310M300US44980,44980,2016,38098,26682,11416
3100000US45060,45060,2006,253573,173699,79874
3100000US45060,45060,2007,250639,171714,78925
3100000US45060,45060,2008,258125,176823,81302
3100000US45060,45060,2009,256596,173824,82772
310M100US45060,45060,2010,255612,171972,83640
310M100US45060,45060,2011,252215,171897,80318
310M100US45060,45060,2012,257456,172983,84473
310M200US45060,45060,2013,256161,172177,83984
310M200US45060,45060,2014,257052,173067,83985
310M200US45060,45060,2015,254001,171360,82641
310M300US45060,45060,2016,253229,169892,83337
3100000US45180,45180,2006,29343,22516,6827
3100000US45180,45180,2007,31545,22896,8649
3100000US45180,45180,2008,30635,21095,9540
3100000US45180,45180,2009,31191,22523,8668
310M100US45180,45180,2010,30119,20436,9683
310M100US45180,45180,2011,32044,20989,11055
310M100US45180,45180,2012,31923,22502,9421
310M200US45180,45180,2013,36038,27154,8884
310M200US45180,45180,2014,34375,25150,9225
310M200US45180,45180,2015,35574,24433,11141
310M300US45180,45180,2016,35703,27926,7777
3100000US45220,45220,2006,139186,83530,55656
3100000US45220,45220,2007,138547,86608,51939
3100000US45220,45220,2008,142778,88033,54745
3100000US45220,45220,2009,141205,80892,60313
310M100US45220,45220,2010,141996,84958,57038
310M100US45220,45220,2011,142521,83799,58722
310M100US45220,45220,2012,140759,82602,58157
310M200US45220,45220,2013,143291,79300,63991
310M200US45220,45220,2014,144333,79301,65032
310M200US45220,45220,2015,142295,80894,61401
310M300US45220,45220,2016,142991,81279,61712
3100000US45300,45300,2006,1110528,783461,327067
3100000US45300,45300,2007,1110634,788863,321771
3100000US45300,45300,2008,1098922,761422,337500
3100000US45300,45300,2009,1091408,740618,350790
310M100US45300,45300,2010,1116299,754280,362019
310M100US45300,45300,2011,1110034,737519,372515
310M100US45300,45300,2012,1131949,727671,404278
310M200US45300,45300,2013,1139923,722699,417224
310M200US45300,45300,2014,1149735,723757,425978
310M200US45300,45300,2015,1166704,734307,432397
310M300US45300,45300,2016,1191645,756808,434837
3100000US45460,45460,2006,67566,47419,20147
3100000US45460,45460,2007,66259,46618,19641
3100000US45460,45460,2008,66688,47782,18906
3100000US45460,45460,2009,67697,47249,20448
310M100US45460,45460,2010,64742,44398,20344
310M100US45460,45460,2011,61346,43231,18115
310M100US45460,45460,2012,65165,43788,21377
310M200US45460,45460,2013,63793,41340,22453
310M200US45460,45460,2014,65313,43106,22207
310M200US45460,45460,2015,66685,42116,24569
310M300US45460,45460,2016,64837,45192,19645
3100000US45500,45500,2006,50254,33023,17231
3100000US45500,45500,2007,49489,31885,17604
3100000US45500,45500,2008,49252,31200,18052
3100000US45500,45500,2009,52249,35180,17069
310M100US45500,45500,2010,50248,34380,15868
310M100US45500,45500,2011,48331,32818,15513
310M100US45500,45500,2012,53337,33503,19834
310M200US45500,45500,2013,54354,35146,19208
310M200US45500,45500,2014,54860,35478,19382
310M200US45500,45500,2015,54440,35812,18628
310M300US45500,45500,2016,53799,34430,19369
3100000US45540,45540,2006,32975,28015,4960
3100000US45540,45540,2007,35706,27220,8486
3100000US45540,45540,2008,36280,26475,9805
3100000US45540,45540,2009,33153,27675,5478
310M100US45540,45540,2010,40659,36850,3809
310M100US45540,45540,2011,44917,40390,4527
310M100US45540,45540,2012,45122,40194,4928
310M200US45540,45540,2013,49672,43215,6457
310M200US45540,45540,2014,50209,44764,5445
310M200US45540,45540,2015,51170,46276,4894
310M300US45540,45540,2016,51781,46693,5088
3100000US45640,45640,2006,61220,46103,15117
3100000US45640,45640,2007,62612,45494,17118
3100000US45640,45640,2008,61847,45309,16538
3100000US45640,45640,2009,62701,45400,17301
310M100US45640,45640,2010,65317,45375,19942
310M100US45640,45640,2011,65227,47511,17716
310M100US45640,45640,2012,63527,45634,17893
3100000US45780,45780,2006,263013,178450,84563
3100000US45780,45780,2007,261817,181223,80594
3100000US45780,45780,2008,261088,177726,83362
3100000US45780,45780,2009,261764,176280,85484
310M100US45780,45780,2010,256437,170466,85971
310M100US45780,45780,2011,260405,167103,93302
310M100US45780,45780,2012,260332,168797,91535
310M200US45780,45780,2013,242975,150725,92250
310M200US45780,45780,2014,242952,152286,90666
310M200US45780,45780,2015,242641,151179,91462
310M300US45780,45780,2016,247069,150573,96496
3100000US45820,45820,2006,93727,66477,27250
3100000US45820,45820,2007,95160,66429,28731
3100000US45820,45820,2008,97998,68439,29559
3100000US45820,45820,2009,96851,67569,29282
310M100US45820,45820,2010,94949,62901,32048
310M100US45820,45820,2011,93981,64589,29392
310M100US45820,45820,2012,93196,62450,30746
310M200US45820,45820,2013,92747,61647,31100
310M200US45820,45820,2014,92799,64019,28780
310M200US45820,45820,2015,93078,62250,30828
310M300US45820,45820,2016,92086,62037,30049
3100000US45860,45860,2006,74951,58043,16908
3100000US45860,45860,2007,73732,57977,15755
3100000US45860,45860,2008,74125,57821,16304
3100000US45860,45860,2009,72733,57187,15546
310M100US45860,45860,2010,76398,60173,16225
310M100US45860,45860,2011,75386,58913,16473
310M100US45860,45860,2012,75593,58274,17319
310M200US45860,45860,2013,75029,56798,18231
310M200US45860,45860,2014,73572,56654,16918
310M200US45860,45860,2015,73360,56222,17138
310M300US45860,45860,2016,74105,56055,18050
3100000US45900,45900,2006,58129,46826,11303
3100000US45900,45900,2007,57866,46876,10990
3100000US45900,45900,2008,56921,45849,11072
3100000US45900,45900,2009,58457,45623,12834
310M100US45900,45900,2010,59457,47090,12367
310M100US45900,45900,2011,56721,45120,11601
310M100US45900,45900,2012,58795,47814,10981
310M200US45900,45900,2013,56163,43894,12269
310M200US45900,45900,2014,58898,46216,12682
310M200US45900,45900,2015,60963,47970,12993
310M300US45900,45900,2016,59122,47692,11430
3100000US45940,45940,2006,127216,87262,39954
3100000US45940,45940,2007,128026,89546,38480
3100000US45940,45940,2008,127905,86375,41530
3100000US45940,45940,2009,125904,83419,42485
310M100US45940,45940,2010,131500,88812,42688
310M100US45940,45940,2011,130756,85864,44892
310M100US45940,45940,2012,132004,86024,45980
310M200US45940,45940,2013,131623,84223,47400
310M200US45940,45940,2014,131564,83605,47959
310M200US45940,45940,2015,127965,80484,47481
310M300US45940,45940,2016,128332,80834,47498
3100000US46020,46020,2006,39426,29191,10235
3100000US46020,46020,2007,39708,28349,11359
3100000US46020,46020,2008,41529,29176,12353
3100000US46020,46020,2009,39718,30320,9398
310M100US46020,46020,2010,40851,28278,12573
310M100US46020,46020,2011,41171,30219,10952
310M100US46020,46020,2012,41632,29567,12065
310M200US46020,46020,2013,39115,28215,10900
310M200US46020,46020,2014,40186,30329,9857
310M200US46020,46020,2015,41381,29707,11674
310M300US46020,46020,2016,38708,28880,9828
3100000US46060,46060,2006,371370,244915,126455
3100000US46060,46060,2007,374739,238760,135979
3100000US46060,46060,2008,376725,248526,128199
3100000US46060,46060,2009,367987,242082,125905
310M100US46060,46060,2010,382574,243436,139138
310M100US46060,46060,2011,379801,233230,146571
310M100US46060,46060,2012,386104,237903,148201
310M200US46060,46060,2013,391975,237045,154930
310M200US46060,46060,2014,389737,234179,155558
310M200US46060,46060,2015,395992,240567,155425
310M300US46060,46060,2016,400835,251474,149361
3100000US46100,46100,2006,38290,30293,7997
3100000US46100,46100,2007,39513,28743,10770
3100000US46100,46100,2008,39901,29080,10821
3100000US46100,46100,2009,40274,29511,10763
310M100US46100,46100,2010,37871,26891,10980
310M100US46100,46100,2011,39852,28833,11019
310M100US46100,46100,2012,39891,28345,11546
310M200US46100,46100,2013,39107,27900,11207
310M200US46100,46100,2014,40421,28552,11869
310M200US46100,46100,2015,39438,28296,11142
310M300US46100,46100,2016,40993,28891,12102
3100000US46140,46140,2006,353107,238040,115067
3100000US46140,46140,2007,352879,239091,113788
3100000US46140,46140,2008,360333,242102,118231
3100000US46140,46140,2009,364543,245374,119169
310M100US46140,46140,2010,364083,244460,119623
310M100US46140,46140,2011,366331,245491,120840
310M100US46140,46140,2012,369404,243310,126094
310M200US46140,46140,2013,369747,240482,129265
310M200US46140,46140,2014,375790,245425,130365
310M200US46140,46140,2015,380841,242879,137962
310M300US46140,46140,2016,381722,245312,136410
3100000US46180,46180,2006,48815,35790,13025
3100000US46180,46180,2007,49303,35966,13337
3100000US46180,46180,2008,49464,35609,13855
3100000US46180,46180,2009,49650,38755,10895
310M100US46180,46180,2010,51577,37222,14355
310M100US46180,46180,2011,50230,35819,14411
310M100US46180,46180,2012,51359,37179,14180
310M200US46180,46180,2013,51082,38022,13060
310M200US46180,46180,2014,50641,33387,17254
310M200US46180,46180,2015,55052,37291,17761
310M300US46180,46180,2016,52823,34714,18109
3100000US46220,46220,2006,80216,50005,30211
3100000US46220,46220,2007,82818,53454,29364
3100000US46220,46220,2008,78045,49829,28216
3100000US46220,46220,2009,78561,50142,28419
310M100US46220,46220,2010,77180,51316,25864
310M100US46220,46220,2011,76603,50499,26104
310M100US46220,46220,2012,77713,50777,26936
310M200US46220,46220,2013,81401,52346,29055
310M200US46220,46220,2014,80582,51924,28658
310M200US46220,46220,2015,84889,54609,30280
310M300US46220,46220,2016,86680,54967,31713
3100000US46300,46300,2006,35611,22632,12979
3100000US46300,46300,2007,35342,25309,10033
3100000US46300,46300,2008,35107,24489,10618
3100000US46300,46300,2009,33492,22045,11447
310M100US46300,46300,2010,37786,24581,13205
310M100US46300,46300,2011,35197,21589,13608
310M100US46300,46300,2012,35887,24673,11214
310M200US46300,46300,2013,36474,23773,12701
310M200US46300,46300,2014,37258,25257,12001
310M200US46300,46300,2015,37707,25065,12642
310M300US46300,46300,2016,38641,26703,11938
3100000US46340,46340,2006,69064,49378,19686
3100000US46340,46340,2007,70777,49529,21248
3100000US46340,46340,2008,69619,50047,19572
3100000US46340,46340,2009,67929,47609,20320
310M100US46340,46340,2010,79341,53274,26067
310M100US46340,46340,2011,80332,54649,25683
310M100US46340,46340,2012,78290,50120,28170
310M200US46340,46340,2013,79043,52501,26542
310M200US46340,46340,2014,77469,47966,29503
310M200US46340,46340,2015,78380,51744,26636
310M300US46340,46340,2016,75792,50513,25279
3100000US46380,46380,2006,33169,21429,11740
3100000US46380,46380,2007,33482,21300,12182
3100000US46380,46380,2008,34519,21170,13349
3100000US46380,46380,2009,33507,21021,12486
310M100US46380,46380,2010,33057,18318,14739
310M100US46380,46380,2011,32497,20447,12050
310M100US46380,46380,2012,35203,18959,16244
310M200US46380,46380,2013,33609,19271,14338
310M200US46380,46380,2014,33464,19242,14222
310M200US46380,46380,2015,35264,20416,14848
310M300US46380,46380,2016,35439,20107,15332
310M200US46520,46520,2013,308800,164417,144383
310M200US46520,46520,2014,309002,168208,140794
310M200US46520,46520,2015,307703,164770,142933
310M300US46520,46520,2016,309169,167342,141827
3100000US46540,46540,2006,118564,78637,39927
3100000US46540,46540,2007,116625,78906,37719
3100000US46540,46540,2008,116839,78734,38105
3100000US46540,46540,2009,117612,80192,37420
310M100US46540,46540,2010,115856,81674,34182
310M100US46540,46540,2011,117730,78930,38800
310M100US46540,46540,2012,118135,79146,38989
310M200US46540,46540,2013,116113,75989,40124
310M200US46540,46540,2014,116231,76608,39623
310M200US46540,46540,2015,114580,76555,38025
310M300US46540,46540,2016,112029,77969,34060
3100000US46660,46660,2006,48871,28579,20292
3100000US46660,46660,2007,49169,31499,17670
3100000US46660,46660,2008,49211,31983,17228
3100000US46660,46660,2009,52655,30290,22365
310M100US46660,46660,2010,50009,29221,20788
310M100US46660,46660,2011,49223,27933,21290
310M100US46660,46660,2012,51065,27253,23812
310M200US46660,46660,2013,51631,27498,24133
310M200US46660,46660,2014,49067,28082,20985
310M200US46660,46660,2015,48600,26535,22065
310M300US46660,46660,2016,52103,28160,23943
3100000US46700,46700,2006,137306,90468,46838
3100000US46700,46700,2007,135338,90775,44563
3100000US46700,46700,2008,136036,86980,49056
3100000US46700,46700,2009,139186,91324,47862
310M100US46700,46700,2010,140202,87615,52587
310M100US46700,46700,2011,139992,85648,54344
310M100US46700,46700,2012,141139,83408,57731
310M200US46700,46700,2013,142577,84317,58260
310M200US46700,46700,2014,145313,84070,61243
310M200US46700,46700,2015,145502,87717,57785
310M300US46700,46700,2016,149172,88501,60671
3100000US47020,47020,2006,40685,26716,13969
3100000US47020,47020,2007,42674,28566,14108
3100000US47020,47020,2008,41253,28452,12801
3100000US47020,47020,2009,41173,27058,14115
310M100US47020,47020,2010,41779,28297,13482
310M100US47020,47020,2011,42381,30028,12353
310M100US47020,47020,2012,42565,27941,14624
310M200US47020,47020,2013,35115,24026,11089
310M200US47020,47020,2014,35523,23863,11660
310M200US47020,47020,2015,35842,25076,10766
310M300US47020,47020,2016,35180,22376,12804
3100000US47220,47220,2006,50047,33336,16711
3100000US47220,47220,2007,50885,35370,15515
3100000US47220,47220,2008,51264,35093,16171
3100000US47220,47220,2009,51597,34941,16656
310M100US47220,47220,2010,50237,33219,17018
310M100US47220,47220,2011,49716,34269,15447
310M100US47220,47220,2012,50068,34006,16062
310M200US47220,47220,2013,50066,31524,18542
310M200US47220,47220,2014,50593,31321,19272
310M200US47220,47220,2015,50380,32877,17503
310M300US47220,47220,2016,50787,30879,19908
3100000US47260,47260,2006,621181,405119,216062
3100000US47260,47260,2007,623695,405970,217725
3100000US47260,47260,2008,621768,395700,226068
3100000US47260,47260,2009,626620,395767,230853
310M100US47260,47260,2010,618426,394868,223558
310M100US47260,47260,2011,612156,392416,219740
310M100US47260,47260,2012,623964,379461,244503
310M200US47260,47260,2013,625540,382391,243149
310M200US47260,47260,2014,637189,381639,255550
310M200US47260,47260,2015,642911,388768,254143
310M300US47260,47260,2016,639903,387069,252834
3100000US47300,47300,2006,122153,72770,49383
3100000US47300,47300,2007,122613,72453,50160
3100000US47300,47300,2008,124047,73086,50961
3100000US47300,47300,2009,126409,72208,54201
310M100US47300,47300,2010,129590,75913,53677
310M100US47300,47300,2011,131890,76347,55543
310M100US47300,47300,2012,132614,75044,57570
310M200US47300,47300,2013,133409,70872,62537
310M200US47300,47300,2014,132742,75875,56867
310M200US47300,47300,2015,134801,73894,60907
310M300US47300,47300,2016,135648,77556,58092
3100000US47380,47380,2006,80032,49691,30341
3100000US47380,47380,2007,82861,50583,32278
3100000US47380,47380,2008,83068,48502,34566
3100000US47380,47380,2009,81349,48525,32824
310M100US47380,47380,2010,83212,49120,34092
310M100US47380,47380,2011,84117,50341,33776
310M100US47380,47380,2012,85171,53156,32015
310M200US47380,47380,2013,93195,51838,41357
310M200US47380,47380,2014,93166,55017,38149
310M200US47380,47380,2015,93239,55692,37547
310M300US47380,47380,2016,92256,55303,36953
310M200US47460,47460,2013,23390,14177,9213
310M200US47460,47460,2014,23296,16075,7221
310M200US47460,47460,2015,24201,15623,8578
310M300US47460,47460,2016,23748,15564,8184
3100000US47580,47580,2006,49756,33479,16277
3100000US47580,47580,2007,48036,33588,14448
3100000US47580,47580,2008,50819,34326,16493
3100000US47580,47580,2009,52771,35928,16843
310M100US47580,47580,2010,50823,34097,16726
310M100US47580,47580,2011,52603,35809,16794
310M100US47580,47580,2012,52832,36058,16774
310M200US47580,47580,2013,66537,41910,24627
310M200US47580,47580,2014,67667,42834,24833
310M200US47580,47580,2015,69562,43712,25850
310M300US47580,47580,2016,68333,45007,23326
3100000US47700,47700,2006,28890,21902,6988
3100000US47700,47700,2007,30321,22114,8207
3100000US47700,47700,2008,30572,23631,6941
3100000US47700,47700,2009,31497,24322,7175
310M100US47700,47700,2010,29560,21572,7988
310M100US47700,47700,2011,28664,22388,6276
310M100US47700,47700,2012,29592,22991,6601
310M200US47700,47700,2013,28649,22695,5954
310M200US47700,47700,2014,29741,21022,8719
310M200US47700,47700,2015,29867,21792,8075
310M300US47700,47700,2016,30494,22321,8173
3100000US47900,47900,2006,1942516,1318546,623970
3100000US47900,47900,2007,1958104,1329204,628900
3100000US47900,47900,2008,1981003,1327553,653450
3100000US47900,47900,2009,1986757,1311525,675232
310M100US47900,47900,2010,2042154,1311774,730380
310M100US47900,47900,2011,2071390,1317084,754306
310M100US47900,47900,2012,2085494,1311279,774215
310M200US47900,47900,2013,2133062,1337315,795747
310M200US47900,47900,2014,2154147,1350612,803535
310M200US47900,47900,2015,2172310,1352332,819978
310M300US47900,47900,2016,2191806,1368189,823617
3100000US47940,47940,2006,64853,46912,17941
3100000US47940,47940,2007,65739,47612,18127
3100000US47940,47940,2008,65698,48402,17296
3100000US47940,47940,2009,67736,47338,20398
310M100US47940,47940,2010,64831,44226,20605
310M100US47940,47940,2011,66619,47308,19311
310M100US47940,47940,2012,66320,47395,18925
310M200US47940,47940,2013,66602,46438,20164
310M200US47940,47940,2014,67957,46848,21109
310M200US47940,47940,2015,66986,46793,20193
310M300US47940,47940,2016,66869,45555,21314
3100000US48020,48020,2006,30065,21192,8873
3100000US48020,48020,2007,31334,22752,8582
3100000US48020,48020,2008,30699,22558,8141
3100000US48020,48020,2009,30603,21674,8929
310M100US48020,48020,2010,31895,22733,9162
310M100US48020,48020,2011,32457,23828,8629
310M100US48020,48020,2012,32360,23205,9155
310M200US48020,48020,2013,32613,23174,9439
310M200US48020,48020,2014,31607,22175,9432
310M200US48020,48020,2015,32753,22812,9941
310M300US48020,48020,2016,32378,21574,10804
3100000US48060,48060,2006,43158,24522,18636
3100000US48060,48060,2007,44250,27230,17020
3100000US48060,48060,2008,44972,27245,17727
3100000US48060,48060,2009,45266,26776,18490
310M100US48060,48060,2010,45163,25399,19764
310M100US48060,48060,2011,46322,25715,20607
310M100US48060,48060,2012,45845,26530,19315
310M200US48060,48060,2013,42466,23054,19412
310M200US48060,48060,2014,43516,23769,19747
310M200US48060,48060,2015,43145,23828,19317
310M300US48060,48060,2016,41415,24188,17227
3100000US48140,48140,2006,51901,40493,11408
3100000US48140,48140,2007,52461,39461,13000
3100000US48140,48140,2008,53992,38974,15018
3100000US48140,48140,2009,53208,39703,13505
310M100US48140,48140,2010,51851,38302,13549
310M100US48140,48140,2011,53343,39038,14305
310M100US48140,48140,2012,52147,38250,13897
310M200US48140,48140,2013,54422,39322,15100
310M200US48140,48140,2014,54739,41395,13344
310M200US48140,48140,2015,54558,39704,14854
310M300US48140,48140,2016,55147,40115,15032
3100000US48260,48260,2006,52748,38385,14363
3100000US48260,48260,2007,52160,38655,13505
3100000US48260,48260,2008,52981,39104,13877
3100000US48260,48260,2009,51403,38982,12421
310M200US48260,48260,2013,50523,35764,14759
310M200US48260,48260,2014,51058,34586,16472
310M200US48260,48260,2015,50699,36123,14576
310M300US48260,48260,2016,48495,34890,13605
3100000US48300,48300,2006,38805,27670,11135
3100000US48300,48300,2007,39965,28188,11777
3100000US48300,48300,2008,39388,27245,12143
3100000US48300,48300,2009,39305,26672,12633
310M100US48300,48300,2010,40402,26643,13759
310M100US48300,48300,2011,41349,28663,12686
310M100US48300,48300,2012,41750,28004,13746
310M200US48300,48300,2013,41368,26194,15174
310M200US48300,48300,2014,41500,28895,12605
310M200US48300,48300,2015,41304,28542,12762
310M300US48300,48300,2016,43186,29218,13968
3100000US48540,48540,2006,62222,44113,18109
3100000US48540,48540,2007,62084,44655,17429
3100000US48540,48540,2008,61521,45055,16466
3100000US48540,48540,2009,61217,44532,16685
310M100US48540,48540,2010,60776,46012,14764
310M100US48540,48540,2011,60046,44288,15758
310M100US48540,48540,2012,61627,42673,18954
310M200US48540,48540,2013,60546,44474,16072
310M200US48540,48540,2014,58775,42026,16749
310M200US48540,48540,2015,58313,43541,14772
310M300US48540,48540,2016,57441,40913,16528
3100000US48580,48580,2006,37863,27499,10364
3100000US48580,48580,2007,38291,28064,10227
3100000US48580,48580,2008,36709,26909,9800
3100000US48580,48580,2009,40219,27330,12889
310M100US48580,48580,2010,39108,26499,12609
310M100US48580,48580,2011,39012,27104,11908
310M100US48580,48580,2012,39758,26728,13030
310M200US48580,48580,2013,40292,27707,12585
310M200US48580,48580,2014,39679,25455,14224
310M200US48580,48580,2015,38106,26229,11877
310M300US48580,48580,2016,40039,26777,13262
3100000US48620,48620,2006,233056,161629,71427
3100000US48620,48620,2007,231108,162414,68694
3100000US48620,48620,2008,241543,162716,78827
3100000US48620,48620,2009,243299,163702,79597
310M100US48620,48620,2010,235977,160198,75779
310M100US48620,48620,2011,237408,160355,77053
310M100US48620,48620,2012,239925,156656,83269
310M200US48620,48620,2013,242612,157729,84883
310M200US48620,48620,2014,240230,157821,82409
310M200US48620,48620,2015,244522,159583,84939
310M300US48620,48620,2016,244765,160394,84371
3100000US48660,48660,2006,57520,37032,20488
3100000US48660,48660,2007,56514,37351,19163
3100000US48660,48660,2008,56151,38293,17858
3100000US48660,48660,2009,56969,37130,19839
310M100US48660,48660,2010,54996,36166,18830
310M100US48660,48660,2011,52528,36184,16344
310M100US48660,48660,2012,56261,34816,21445
310M200US48660,48660,2013,57532,36804,20728
310M200US48660,48660,2014,54196,35894,18302
310M200US48660,48660,2015,55562,34638,20924
310M300US48660,48660,2016,56183,34194,21989
3100000US48700,48700,2006,47465,32542,14923
3100000US48700,48700,2007,47761,33735,14026
3100000US48700,48700,2008,47778,33181,14597
3100000US48700,48700,2009,48061,32980,15081
310M100US48700,48700,2010,45611,30899,14712
310M100US48700,48700,2011,46506,31847,14659
310M100US48700,48700,2012,45595,32158,13437
310M200US48700,48700,2013,44961,32478,12483
310M200US48700,48700,2014,45742,31533,14209
310M200US48700,48700,2015,45751,31638,14113
310M300US48700,48700,2016,45525,30989,14536
3100000US48740,48740,2006,43832,31238,12594
3100000US48740,48740,2007,43627,31717,11910
3100000US48740,48740,2008,42669,29870,12799
3100000US48740,48740,2009,41254,28778,12476
310M100US48740,48740,2010,44756,31963,12793
310M100US48740,48740,2011,45032,31838,13194
310M100US48740,48740,2012,43167,30834,12333
3100000US48900,48900,2006,140894,96547,44347
3100000US48900,48900,2007,147137,97700,49437
3100000US48900,48900,2008,147921,103075,44846
3100000US48900,48900,2009,153938,105234,48704
310M100US48900,48900,2010,151338,102638,48700
310M100US48900,48900,2011,151967,97739,54228
310M100US48900,48900,2012,152292,100976,51316
310M200US48900,48900,2013,106814,63604,43210
310M200US48900,48900,2014,110993,68118,42875
310M200US48900,48900,2015,111546,68937,42609
310M300US48900,48900,2016,114024,69336,44688
3100000US48980,48980,2006,29596,18776,10820
3100000US48980,48980,2007,30545,19735,10810
3100000US48980,48980,2008,31566,18814,12752
3100000US48980,48980,2009,30932,18296,12636
310M100US48980,48980,2010,32762,19185,13577
310M100US48980,48980,2011,30750,18548,12202
310M100US48980,48980,2012,31762,18439,13323
310M200US48980,48980,2013,31657,20733,10924
310M200US48980,48980,2014,32691,18610,14081
310M200US48980,48980,2015,32324,19406,12918
310M300US48980,48980,2016,30897,19032,11865
3100000US49020,49020,2006,46412,35176,11236
3100000US49020,49020,2007,44284,32470,11814
3100000US49020,49020,2008,46412,32062,14350
3100000US49020,49020,2009,48764,34018,14746
310M100US49020,49020,2010,49365,32347,17018
310M100US49020,49020,2011,50524,32671,17853
310M100US49020,49020,2012,50815,33761,17054
310M200US49020,49020,2013,49477,31898,17579
310M200US49020,49020,2014,51140,34040,17100
310M200US49020,49020,2015,48995,33750,15245
310M300US49020,49020,2016,52538,37808,14730
3100000US49180,49180,2006,180612,125670,54942
3100000US49180,49180,2007,182959,127127,55832
3100000US49180,49180,2008,184796,129061,55735
3100000US49180,49180,2009,187735,131913,55822
310M100US49180,49180,2010,187786,130354,57432
310M100US49180,49180,2011,189075,128914,60161
310M100US49180,49180,2012,193105,126000,67105
310M200US49180,49180,2013,255660,173720,81940
310M200US49180,49180,2014,256999,169917,87082
310M200US49180,49180,2015,260437,169305,91132
310M300US49180,49180,2016,258760,172302,86458
310M200US49220,49220,2013,31724,23816,7908
310M200US49220,49220,2014,32383,24020,8363
310M200US49220,49220,2015,30960,22402,8558
310M300US49220,49220,2016,32749,23502,9247
3100000US49300,49300,2006,42063,32206,9857
3100000US49300,49300,2007,42417,31173,11244
3100000US49300,49300,2008,42989,32717,10272
3100000US49300,49300,2009,42457,31352,11105
310M100US49300,49300,2010,41530,31766,9764
310M100US49300,49300,2011,42635,31727,10908
310M100US49300,49300,2012,42246,30250,11996
310M200US49300,49300,2013,43848,31563,12285
310M200US49300,49300,2014,42830,31079,11751
310M200US49300,49300,2015,42439,30632,11807
310M300US49300,49300,2016,43277,30823,12454
3100000US49340,49340,2006,290280,198819,91461
3100000US49340,49340,2007,289780,200030,89750
3100000US49340,49340,2008,292767,199272,93495
3100000US49340,49340,2009,295973,200529,95444
310M100US49340,49340,2010,296295,193525,102770
310M100US49340,49340,2011,296948,192527,104421
310M100US49340,49340,2012,300308,193222,107086
310M200US49340,49340,2013,345518,223692,121826
310M200US49340,49340,2014,344496,222678,121818
310M200US49340,49340,2015,345269,225400,119869
310M300US49340,49340,2016,349567,226101,123466
3100000US49420,49420,2006,76522,49572,26950
3100000US49420,49420,2007,77682,50155,27527
3100000US49420,49420,2008,77409,51103,26306
3100000US49420,49420,2009,79998,51751,28247
310M100US49420,49420,2010,79875,48747,31128
310M100US49420,49420,2011,80071,48397,31674
310M100US49420,49420,2012,78472,48712,29760
310M200US49420,49420,2013,79742,49174,30568
310M200US49420,49420,2014,79700,51569,28131
310M200US49420,49420,2015,81709,52368,29341
310M300US49420,49420,2016,81084,50865,30219
3100000US49500,49500,2006,35519,27808,7711
3100000US49500,49500,2007,34641,25395,9246
3100000US49500,49500,2008,34722,24708,10014
3100000US49500,49500,2009,33894,25067,8827
310M100US49500,49500,2010,32875,24368,8507
310M100US49500,49500,2011,30006,24580,5426
310M100US49500,49500,2012,30718,24184,6534
3100000US49620,49620,2006,162285,124348,37937
3100000US49620,49620,2007,165004,128380,36624
3100000US49620,49620,2008,165676,124273,41403
3100000US49620,49620,2009,165368,126202,39166
310M100US49620,49620,2010,170055,130744,39311
310M100US49620,49620,2011,167625,124426,43199
310M100US49620,49620,2012,168508,125306,43202
310M200US49620,49620,2013,164937,120619,44318
310M200US49620,49620,2014,169212,126916,42296
310M200US49620,49620,2015,165672,122239,43433
310M300US49620,49620,2016,169885,128886,40999
3100000US49660,49660,2006,234545,173469,61076
3100000US49660,49660,2007,231895,169733,62162
3100000US49660,49660,2008,234938,169709,65229
3100000US49660,49660,2009,233687,171383,62304
310M100US49660,49660,2010,228960,166062,62898
310M100US49660,49660,2011,231532,163395,68137
310M100US49660,49660,2012,229328,159688,69640
310M200US49660,49660,2013,229074,158755,70319
310M200US49660,49660,2014,228797,160582,68215
310M200US49660,49660,2015,228692,159850,68842
310M300US49660,49660,2016,228427,158565,69862
3100000US49700,49700,2006,54586,32907,21679
3100000US49700,49700,2007,55450,33938,21512
3100000US49700,49700,2008,56215,33369,22846
3100000US49700,49700,2009,55805,34963,20842
310M100US49700,49700,2010,55241,32940,22301
310M100US49700,49700,2011,55418,33196,22222
310M100US49700,49700,2012,56101,33188,22913
310M200US49700,49700,2013,56806,33002,23804
310M200US49700,49700,2014,57366,33186,24180
310M200US49700,49700,2015,58262,34168,24094
310M300US49700,49700,2016,59044,31137,27907
3100000US49740,49740,2006,69922,49630,20292
3100000US49740,49740,2007,70173,49382,20791
3100000US49740,49740,2008,69370,48009,21361
3100000US49740,49740,2009,71680,49169,22511
310M100US49740,49740,2010,67750,48719,19031
310M100US49740,49740,2011,71490,51009,20481
310M100US49740,49740,2012,70895,47949,22946
310M200US49740,49740,2013,69744,48590,21154
310M200US49740,49740,2014,70593,46670,23923
310M200US49740,49740,2015,71751,46863,24888
310M300US49740,49740,2016,73072,49974,23098
3100000US49780,49780,2006,32376,23453,8923
3100000US49780,49780,2007,32290,23827,8463
3100000US49780,49780,2008,32286,23163,9123
3100000US49780,49780,2009,32265,22067,10198
310M100US49780,49780,2010,34238,23808,10430
310M100US49780,49780,2011,34639,23932,10707
310M100US49780,49780,2012,33675,23030,10645
310M200US49780,49780,2013,34207,23601,10606
310M200US49780,49780,2014,33921,21829,12092
310M200US49780,49780,2015,34150,22164,11986
310M300US49780,49780,2016,34169,22850,11319
